Accipiter_castanilius,8199,8193,6,80,59
Accipiter_cirrocephalus,8209,8206,3,64,65
Accipiter_fasciatus,8229,8216,13,49,60
Accipiter_rufitorques,8234,8230,4,50,54
Accipiter_hiogaster,8157,8150,7,94,87
Accipiter_novaehollandiae,8194,8187,7,63,81
Accipiter_erythropus,8209,8206,3,60,69
Accipiter_soloensis,8228,8213,15,44,66
Accipiter_virgatus,8248,8243,5,38,52
Accipiter_cooperii,7940,7934,6,200,198
Accipiter_gentilis,8283,8242,41,11,44
Accipiter_melanochlamys,8283,8242,41,11,44
Accipiter_melanoleucus,8034,8025,9,160,144
Accipiter_meyerianus,7384,7381,3,384,570
Accipiter_nisus,8124,8111,13,117,97
Accipiter_rufiventris,8207,8192,15,58,73
Accipiter_striatus,8157,8145,12,87,94
Circus_approximans,8207,8194,13,74,57
Circus_hudsonius,8225,8219,6,56,57
Megatriorchis_doriae,8233,8231,2,47,58
Busarellus_nigricollis,8220,8196,24,63,55
Rostrhamus_sociabilis,8240,8214,26,48,50
Buteo_albigula,8242,8239,3,49,47
Buteo_buteo,8241,8215,26,45,52
Buteo_hemilasius,8249,8225,24,43,46
Buteo_rufinus,8234,8231,3,49,55
Buteo_japonicus,8271,8229,42,25,42
Buteo_lagopus,8215,8202,13,59,64
Buteo_jamaicensis,8239,8220,19,54,45
Buteo_albonotatus,8227,8212,15,53,58
Buteo_lineatus,8232,8205,27,57,49
Buteo_platypterus,8248,8227,21,40,50
Buteo_ventralis,8018,8015,3,167,153
Buteo_swainsoni,8148,8139,9,72,118
Leucopternis_kuhli,8240,8232,8,43,55
Buteo_nitidus,7937,7933,4,199,202
Geranoaetus_albicaudatus,7975,7962,13,165,198
Geranoaetus_polyosoma,8215,8200,15,64,59
Buteogallus_aequinoctialis,8199,8183,16,80,59
Buteogallus_meridionalis,8139,8132,7,106,93
Harpyhaliaetus_solitarius,8232,8228,4,56,50
Cryptoleucopteryx_plumbea,8244,8222,22,43,51
Morphnarchus_princeps,8163,8158,5,88,87
Geranospiza_caerulescens,8098,8086,12,155,85
Ictinia_mississippiensis,8242,8227,15,44,52
Butastur_indicus,8241,8236,5,44,53
Butastur_rufipennis,8245,8226,19,42,51
Haliaeetus_leucocephalus,8230,8225,5,19,89
Haliaeetus_leucogaster,8197,8182,15,72,69
Haliastur_indus,8199,8181,18,65,74
Milvus_milvus,8106,8092,14,112,120
Toxostoma_rufum,8115,8111,4,130,93
Accipiter_superciliosus,8240,8216,24,37,61
Harpagus_bidentatus,8242,8218,24,44,52
Melierax_poliopterus,8124,8121,3,126,88
Micronisus_gabar,8138,8126,12,122,78
Aquila_africana,7795,7790,5,326,217
Aquila_chrysaetos,8294,8285,9,10,34
Nisaetus_floris,8106,8093,13,129,103
Aquila_nipalensis,8233,8230,3,49,56
Hieraaetus_ayresii,8204,8187,17,74,60
Hieraaetus_morphnoides,8220,8204,16,59,59
Hieraaetus_pennatus,8233,8212,21,51,54
Spizaetus_melanoleucus,8193,8190,3,84,61
Spizaetus_ornatus,8089,8079,10,144,105
Spizaetus_tyrannus,8220,8213,7,43,75
Harpia_harpyja,8289,8253,36,8,41
Macheiramphus_alcinus,7934,7929,5,213,191
Circaetus_gallicus,8221,8215,6,68,49
Circaetus_pectoralis,8209,8204,5,44,85
Gyps_fulvus,8238,8213,25,45,55
Gyps_himalayensis,8219,8211,8,22,97
Haliaeetus_pelagicus,7788,7743,45,288,262
Elanoides_forficatus,8141,8138,3,105,92
Henicopernis_longicauda,8134,8121,13,97,107
Leptodon_cayanensis,8218,8202,16,57,63
Gypaetus_barbatus,8284,8240,44,15,39
Polyboroides_typus,8187,8177,10,89,62
Aquila_spilogaster,8141,7359,782,73,124
Elanus_axillaris,8216,8213,3,55,67
Gymnogyps_californianus,8198,8148,50,18,122
Sarcoramphus_papa,8114,8100,14,131,93
Chunga_burmeisteri,8245,8238,7,26,67
Athene_cunicularia,8167,8161,6,43,128
Glaucidium_brasilianum,8221,8216,5,40,77
Bubo_bubo,8254,8243,11,26,58
Bubo_scandiacus,8238,8200,38,36,64
Strix_aluco,7926,7904,22,14,398
Strix_occidentalis,8283,8241,42,9,46
Otus_sunia,8247,8234,13,28,63
Ciccaba_nigrolineata,7978,7954,24,134,226
Tyto_alba,8283,8216,67,12,43
Falco_berigora,8055,8044,11,145,138
Falco_biarmicus,8244,8204,40,12,82
Falco_cherrug,8273,8237,36,10,55
Falco_rusticolus,8268,8222,46,21,49
Falco_fasciinucha,8194,8181,13,76,68
Falco_pelegrinoides,8029,8010,19,29,280
Falco_peregrinus,8279,8238,41,11,48
Falco_femoralis,8213,8200,13,58,67
Falco_novaeseelandiae,8213,8203,10,60,65
Falco_deiroleucus,8212,8205,7,59,67
Falco_rufigularis,8229,8209,20,50,59
Falco_columbarius,8210,8201,9,64,64
Falco_cenchroides,8208,8198,10,73,57
Falco_punctatus,8280,8263,17,13,45
Falco_moluccensis,7823,7814,9,221,294
Falco_naumanni,8280,8217,63,15,43
Milvago_chimachima,8043,8036,7,128,167
Herpetotheres_cachinnans,8260,8255,5,20,58
Alca_torda,8270,8253,17,13,55
Uria_aalge,8216,8212,4,50,72
Uria_lomvia,8264,8248,16,17,57
Cepphus_grylle,8262,8243,19,20,56
Fratercula_arctica,8261,8229,32,27,50
Chroicocephalus_ridibundus,8281,8220,61,9,48
Larus_argentatus,8203,8191,12,68,67
Rissa_tridactyla,8282,8229,53,10,46
Sterna_hirundo,8288,8244,44,9,41
Dromas_ardeola,7832,7811,21,229,277
Glareola_pratincola,7950,7924,26,146,242
Phaetusa_simplex,7765,7742,23,199,374
Rynchops_niger,8035,8012,23,110,193
Stercorarius_parasiticus,8054,8040,14,89,195
Bartramia_longicauda,7851,7845,6,243,244
Calidris_pugnax,8258,8191,67,25,55
Calidris_pygmaea,8267,8247,20,28,43
Tringa_solitaria,8223,8220,3,56,59
Xenus_cinereus,8026,8018,8,185,127
Gallinago_delicata,8125,8118,7,88,125
Gallinago_gallinago,8114,8110,4,93,131
Gallinago_paraguaiae,8230,8223,7,40,68
Gallinago_nigripennis,8231,8223,8,44,63
Gallinago_hardwickii,8230,8226,4,49,59
Gallinago_megala,8165,8160,5,74,99
Gallinago_stenura,7987,7978,9,196,155
Gallinago_solitaria,8202,8199,3,72,64
Gallinago_jamesoni,8253,8248,5,33,52
Gallinago_undulata,8243,8237,6,41,54
Scolopax_bukidnonensis,8230,8219,11,42,66
Scolopax_rusticola,7972,7962,10,220,146
Limnodromus_scolopaceus,8244,8237,7,39,55
Nycticryphes_semicollaris,8030,8005,25,91,217
Thinocorus_orbignyianus,8025,8012,13,90,223
Rostratula_benghalensis,8229,8219,10,31,78
Burhinus_bistriatus,7989,7964,25,139,210
Chionis_minor,8050,8032,18,81,207
Himantopus_himantopus,8056,8036,20,89,193
Ibidorhyncha_struthersii,8064,8041,23,87,187
Burhinus_oedicnemus,7684,7652,32,146,508
Charadrius_alexandrinus,8240,8230,10,45,53
Charadrius_vociferus,8261,8237,24,27,50
Pluvialis_apricaria,8281,8243,38,13,44
Podilymbus_podiceps,8008,7992,16,83,247
Anhinga_anhinga,7980,7933,47,129,229
Mesembrinibis_cayennensis,7962,7944,18,138,238
Oceanites_oceanicus,7961,7945,16,145,232
Oceanodroma_tethys,7936,7920,16,162,240
Pelecanoides_urinatrix,7846,7818,28,235,257
Butorides_virescens,7951,7882,69,182,205
Aptenodytes_forsteri,8277,8270,7,18,43
Aptenodytes_patagonicus,8120,8085,35,107,111
Eudyptes_chrysocome,8238,8220,18,40,60
Eudyptes_filholi,8258,8246,12,25,55
Eudyptes_moseleyi,8255,8232,23,30,53
Eudyptes_pachyrhynchus,8283,7888,395,19,36
Eudyptes_sclateri,8252,8236,16,33,53
Eudyptes_chrysolophus,8205,7641,564,67,66
Eudyptes_schlegeli,8244,8187,57,36,58
Megadyptes_antipodes_antipodes,8178,8133,45,78,82
Eudyptula_albosignata,8174,7648,526,73,91
Eudyptula_minor,8184,7523,661,74,80
Eudyptula_novaehollandiae,8223,7921,302,46,69
Spheniscus_demersus,8147,8132,15,97,94
Spheniscus_humboldti,8291,8230,61,9,38
Spheniscus_magellanicus,8278,8221,57,20,40
Pygoscelis_antarcticus,8161,8105,56,91,86
Pygoscelis_papua,8169,8142,27,84,85
Eudyptes_robustus,7886,7830,56,212,240
Oceanodroma_leucorhoa,8279,8268,11,12,47
Puffinus_mauretanicus,8214,8202,12,47,77
Ciconia_abdimii,8195,8192,3,75,68
Ciconia_episcopus,8231,8230,1,47,60
Ciconia_stormi,8143,8138,5,114,81
Ciconia_boyciana,8267,8248,19,29,42
Ciconia_ciconia,8258,8197,61,29,51
Ciconia_maguari,8276,8261,15,12,50
Ciconia_nigra,8225,8223,2,52,61
Cochlearius_cochlearius,8253,8248,5,24,61
Egretta_garzetta,8257,8251,6,31,50
Gorsachius_magnificus,8277,8272,5,14,47
Nipponia_nippon,8257,8232,25,28,53
Threskiornis_aethiopicus,7867,7861,6,62,409
Theristicus_caerulescens,8275,8263,12,14,49
Morus_bassanus,8280,8256,24,12,46
Phalacrocorax_aristotelis,8263,8228,35,9,66
Phalacrocorax_pelagicus,8252,8246,6,41,45
Phalacrocorax_auritus,8254,8177,77,36,48
Phalacrocorax_harrisi,8278,8270,8,17,43
Gavia_stellata,8294,8274,20,8,36
Phoenicopterus_ruber_ruber,8276,8231,45,11,51
Corythaixoides_concolor,8201,8187,14,60,77
Rhynochetos_jubatus,8267,8237,30,14,57
Aramus_guarauna,8050,8032,18,91,197
Psophia_crepitans,8010,8001,9,108,220
Balearica_regulorum,8057,8055,2,165,116
Grus_americana,8295,8242,53,11,32
Grus_nigricollis,8261,8235,26,13,64
Fulica_atra,8042,7991,51,134,162
Laterallus_jamaicensis_coturniculus,8252,8236,16,18,68
Porphyrio_hochstetteri,8238,8208,30,15,85
Hypotaenidia_okinawae,8275,8257,18,11,52
Rallus_crepitans,7853,7806,47,197,288
Rallus_limicola,8263,8247,16,12,63
Heliornis_fulica,7871,7850,21,169,298
Ardeotis_kori,8001,7980,21,111,226
Tetrax_tetrax,7883,7865,18,178,277
Chlamydotis_undulata_undulata,8118,8112,6,126,94
Otis_tarda,8290,8279,11,9,39
Lophotis_ruficrista,8207,8198,9,48,83
Caprimulgus_europaeus,8275,8240,35,14,49
Chordeiles_acutipennis,7965,7950,15,121,252
Nyctibius_bracteatus,7895,7874,21,170,273
Nyctibius_grandis,8274,8225,49,14,50
Steatornis_caripensis,7919,7880,39,169,250
Acridotheres_javanicus,8189,8169,20,44,105
Acridotheres_tristis,8273,8244,29,11,54
Sturnus_vulgaris,8265,8240,25,21,52
Lamprotornis_superbus,8229,8208,21,24,85
Rhabdornis_inornatus,8217,8200,17,52,69
Alethe_castanea,8057,8052,5,150,131
Alethe_diademata,8157,8149,8,81,100
Cercotrichas_coryphoeus,8073,8052,21,86,179
Copsychus_sechellarum,8203,8187,16,45,90
Muscicapa_adusta,8086,8077,9,105,147
Muscicapa_striata_striata,8233,8218,15,27,78
Muscicapa_comitata,8115,8105,10,104,119
Chamaetylas_choloensis,8085,8075,10,115,138
Chamaetylas_fuelleborni,8134,8123,11,98,106
Cossypha_dichroa,8187,8175,12,68,83
Cossypha_heuglini,8197,8189,8,64,77
Cossypha_niveicapilla,8230,8221,9,47,61
Cossypha_polioptera,8101,8089,12,124,113
Cossypha_caffra,8056,8047,9,154,128
Cichladusa_arquata,8133,8122,11,107,98
Pogonocichla_stellata,8085,8079,6,131,122
Erithacus_rubecula,8234,8217,17,20,84
Ficedula_albicollis,8249,8228,21,23,66
Oenanthe_melanoleuca,8230,8195,35,38,70
Saxicola_maurus_maurus,8165,8153,12,53,120
Catharus_bicknelli,7987,7960,27,143,208
Catharus_minimus,8053,8034,19,117,168
Catharus_ustulatus,8264,8055,209,13,61
Turdus_rufiventris,8080,8061,19,101,157
Sialia_sialis,7755,7746,9,88,495
Elachura_formosa,8038,7957,81,126,174
Certhia_americana,8202,8136,66,42,94
Certhia_brachydactyla,8206,8190,16,59,73
Sitta_carolinensis,8177,8153,24,16,145
Agelaius_phoeniceus,8277,8251,26,10,51
Agelaius_tricolor,8277,8253,24,9,52
Molothrus_ater,8275,8231,44,11,52
Geothlypis_trichas,8101,8001,100,33,204
Setophaga_kirtlandii,8037,8029,8,171,130
Setophaga_petechia,8193,8125,68,17,128
Ammospiza_caudacuta,8274,8248,26,15,49
Ammospiza_nelsoni,8261,8236,25,14,63
Melospiza_georgiana,8229,8205,24,15,94
Melospiza_melodia,8240,8207,33,17,81
Passerculus_sandwichensis,8273,8241,32,12,53
Artemisiospiza_belli,8268,8243,25,13,57
Melozone_crissalis,8284,8243,41,12,42
Junco_hyemalis,8167,8157,10,65,106
Zonotrichia_leucophrys,8266,8242,24,13,59
Emberiza_elegans,8176,8158,18,27,135
Camarhynchus_parvulus,8249,8239,10,12,77
Geospiza_fortis,8226,8208,18,37,75
Sporophila_hypoxantha,7624,7598,26,32,682
Diglossa_brunneiventris,8212,8142,70,17,109
Nesospiza_acunhae,8233,8219,14,44,61
Cardinalis_cardinalis,8211,8200,11,58,69
Calcarius_ornatus,8023,8005,18,127,188
Rhodinocichla_rosea,8196,8185,11,45,97
Carduelis_carduelis,8222,8211,11,41,75
Serinus_canaria,8255,8235,20,15,68
Serinus_canicollis,8136,8125,11,95,107
Spinus_pinus,8221,8208,13,44,73
Loxia_curvirostra,8239,8224,15,37,62
Haemorhous_mexicanus,8259,8234,25,10,69
Chlorodrepanis_virens,8156,8143,13,84,98
Hemignathus_wilsoni,8204,8177,27,59,75
Leucosticte_australis,8199,8180,19,37,102
Fringilla_coelebs,8280,8261,19,12,46
Motacilla_tschutschensis,8059,8048,11,103,176
Montifringilla_adamsi,8277,8258,19,18,43
Pyrgilauda_ruficollis,8261,8250,11,26,51
Onychostruthus_taczanowskii,8279,8269,10,16,43
Passer_domesticus,8174,8162,12,55,109
Passer_montanus,8266,8256,10,24,48
Prunella_himalayana,8133,8123,10,73,132
Anomalospiza_imberbis,8273,8241,32,18,47
Vidua_chalybeata,8280,8262,18,12,46
Vidua_macroura,8258,8239,19,14,66
Chloebia_gouldiae,8151,8033,118,89,98
Lonchura_striata,7896,7860,36,215,227
Taeniopygia_guttata,8245,8225,20,16,77
Dicaeum_eximium,8217,8198,19,55,66
Acrocephalus_arundinaceus,8266,8052,214,12,60
Acrocephalus_familiaris_kingi,7985,7936,49,77,276
Acrocephalus_scirpaceus_scirpaceus,8178,8135,43,23,137
Prinia_subflava,8251,8092,159,17,70
Brachypodius_atriceps,7788,7777,11,79,471
Chamaea_fasciata,8263,8235,28,10,65
Sylvia_atricapilla,8216,8124,92,20,102
Sylvia_borin,8236,8212,24,13,89
Cyanoderma_ruficeps,8229,8208,21,39,70
Mixornis_gularis,8094,8084,10,90,154
Zosterops_borbonicus,8216,8155,61,51,71
Zosterops_lateralis_melanops,8162,8149,13,67,109
Phylloscopus_collybita,8274,8187,87,12,52
Phylloscopus_trochilus_acredula,8126,8084,42,25,187
Phylloscopus_whistleri,8268,8064,204,15,55
Hirundo_rustica,8204,8173,31,25,109
Hirundo_rustica_rustica,8271,8132,139,12,55
Progne_subis_subis,7860,7631,229,56,422
Tachycineta_bicolor,8158,8076,82,73,107
Sylvietta_virens,8160,8151,9,58,120
Alauda_arvensis,8210,8153,57,44,84
Eremophila_alpestris_peregrina,8243,8221,22,32,63
Cyanistes_caeruleus,8227,8150,77,38,73
Parus_major,8244,8234,10,28,66
Pseudopodoces_humilis,8286,8271,15,8,44
Periparus_ater,8272,8257,15,11,55
Poecile_atricapillus,8283,7742,541,7,48
Alaudala_cheleensis,7726,7682,44,244,368
Cisticola_juncidis,7889,7865,24,159,290
Donacobius_atricapilla,7920,7894,26,151,267
Locustella_ochotensis,7927,7903,24,115,296
Erythrocercus_mccallii,7617,7574,43,296,425
Hylia_prasina,7911,7891,20,132,295
Rhadina_sibilatrix,7777,7753,24,217,344
Hippolais_icterina,7780,7759,21,193,365
Illadopsis_cleaveri,7837,7819,18,183,318
Sterrhoptilus_dennistouni,7936,7910,26,131,271
Zosterops_hypoxanthus,7719,7693,26,256,363
Zosterops_pallidus,7834,7799,35,173,331
Sinosuthora_webbiana,7941,7912,29,120,277
Bombycilla_garrulus,7864,7848,16,184,290
Phainopepla_nitens,7915,7900,15,161,262
Polioptila_caerulea,7951,7926,25,130,257
Thryothorus_ludovicianus,7790,7769,21,215,333
Sitta_europaea,7933,7911,22,136,269
Chloropsis_hardwickii,7735,7709,26,213,390
Irena_cyanogastra,7824,7790,34,207,307
Leptocoma_aspasia,8004,7979,25,99,235
Promerops_cafer,7972,7946,26,131,235
Emberiza_fucata,7677,7657,20,240,421
Loxia_leucoptera,7923,7900,23,143,272
Motacilla_alba,7977,7952,25,120,241
Ploceus_nigricollis,7980,7958,22,113,245
Urocynchramus_pylzowi,8009,7991,18,102,227
Leucopsar_rothschildi,7704,7671,33,283,351
Toxostoma_redivivum,7932,7904,28,133,273
Oenanthe_oenanthe,7897,7882,15,160,281
Callaeas_wilsoni,7864,7842,22,235,239
Melanocharis_versteri,7993,7977,16,96,249
Eopsaltria_australis,8198,7924,274,39,101
Cnemophilus_loriae,8245,8233,12,44,49
Aleadryas_rufinucha,7842,7822,20,202,294
Oriolus_oriolus,8001,7981,20,98,239
Pachycephala_philippinensis,7936,7916,20,119,283
Oreocharis_arfaki,7968,7943,25,122,248
Vireo_altiloquus,7967,7942,25,136,235
Daphoenositta_chrysoptera,7995,7981,14,108,235
Platysteira_castanea,7982,7959,23,108,248
Ptilorrhoa_leucosticta,7800,7774,26,182,356
Chaetorhynchus_papuensis,7934,7897,37,117,287
Rhipidura_dahli,8015,8000,15,102,221
Ifrita_kowaldi,7949,7925,24,153,236
Myiagra_hebetior,8020,7998,22,101,217
Lanius_ludovicianus,7989,7972,17,96,253
Aphelocoma_californica,8264,8237,27,11,63
Aphelocoma_coerulescens,8268,8258,10,17,53
Cyanocitta_stelleri,8281,8261,20,13,44
Coloeus_monedula,8176,8160,16,15,147
Corvus_brachyrhynchos,8252,8236,16,25,61
Corvus_cornix,8246,8223,23,13,79
Corvus_hawaiiensis,8286,8268,18,10,42
Corvus_kubaryi,8114,7852,262,36,188
Corvus_moneduloides,8260,8238,22,15,63
Pica_pica,8233,8223,10,46,59
Garrulus_glandarius,8238,8229,9,41,59
Lanius_collurio,7956,7382,574,192,190
Cicinnurus_regius,8240,8224,16,35,63
Diphyllodes_magnificus,8243,8230,13,25,70
Paradisaea_raggiana,8211,8203,8,60,67
Paradisaea_rubra,8253,8241,12,26,59
Parotia_lawesii,8253,8240,13,23,62
Lycocorax_pyrrhopterus_obiensis,8261,8221,40,19,58
Struthidea_cinerea,8252,8246,6,35,51
Monarcha_castaneiventris_obscurior,8285,8267,18,9,44
Dicrurus_megarhynchus,8253,8239,14,34,51
Edolisoma_coerulescens,8256,8245,11,29,53
Eulacestoma_nigropectus,8250,8246,4,35,53
Falcunculus_frontatus,8225,8217,8,51,62
Pteruthius_melanotis,8190,8172,18,62,86
Gymnorhina_tibicen,8205,8199,6,60,73
Rhagologus_leucostigma,8252,8243,9,31,55
Machaerirhynchus_nigripectus,8245,8237,8,40,53
Orthonyx_spaldingii,8242,8235,7,42,54
Dasyornis_broadbenti,8240,8231,9,37,61
Entomyzon_cyanotis,8280,8211,69,13,45
Lichenostomus_cassidix,8273,8194,79,21,44
Grantiella_picta,8207,8202,5,55,76
Origma_solitaria,8217,8203,14,52,69
Malurus_alboscapulatus,8213,8203,10,42,83
Malurus_melanocephalus,8118,8072,46,71,149
Malurus_cyaneus_samueli,8163,8129,34,40,135
Malurus_elegans,7847,7824,23,166,325
Climacteris_rufus,8030,8016,14,88,220
Amblyornis_subalaris,8282,8267,15,11,45
Ptilonorhynchus_violaceus,8237,8226,11,40,61
Atrichornis_clamosus,7952,7932,20,163,223
Menura_novaehollandiae,8261,8249,12,24,53
Campylorhamphus_procurvoides,8197,8185,12,60,81
Sclerurus_mexicanus,8216,8204,12,50,72
Formicarius_rufipectus,8176,8164,12,69,93
Furnarius_figulus,7833,7810,23,160,345
Scytalopus_superciliaris,7977,7956,21,114,247
Grallaria_varia,7928,7911,17,154,256
Rhegmatorhina_hoffmannsi,8034,8016,18,142,162
Willisornis_vidua,7963,7933,30,183,192
Sakesphorus_luctuosus,7912,7884,28,155,271
Cephalopterus_ornatus,7908,7881,27,171,259
Pachyramphus_minor,8001,7988,13,111,226
Neopipo_cinnamomea,7758,7737,21,201,379
Cossypha_archeri,8194,8189,5,68,76
Tyrannus_verticalis,8236,8228,8,37,65
Tyrannus_tyrannus,8166,8162,4,82,90
Myiozetetes_cayanensis,8268,8256,12,13,57
Empidonax_alnorum,8174,8131,43,70,94
Empidonax_traillii,8177,8132,45,74,87
Pitangus_sulphuratus,7814,7772,42,183,341
Tyrannus_savana,7923,7903,20,147,268
Mionectes_macconnelli,8196,8169,27,53,89
Tachuris_rubrigastra,8232,8224,8,33,73
Piprites_chloris,8241,8231,10,25,72
Onychorhynchus_coronatus,8236,8229,7,30,72
Oxyruncus_cristatus,8236,8231,5,42,60
Chiroxiphia_lanceolata,8264,8238,26,12,62
Corapipo_altera,8234,8200,34,45,59
Lepidothrix_coronata,8202,8188,14,65,71
Manacus_candei,8268,8241,27,13,57
Manacus_vitellinus,8191,8169,22,56,91
Pipra_filicauda,8185,8155,30,45,108
Neopelma_chrysocephalum,8231,8178,53,48,59
Sapayoa_aenigma,7694,7672,22,218,426
Serilophus_lunatus,8206,8198,8,53,79
Smithornis_capensis,8109,8098,11,100,129
Amazona_aestiva,8133,8113,20,65,140
Amazona_collaria,8198,7761,437,58,82
Amazona_guildingii,7913,7876,37,167,258
Ara_ararauna,8244,8219,25,12,82
Ara_glaucogularis,8263,8247,16,10,65
Ara_rubrogenys,8261,8203,58,14,63
Aratinga_solstitialis,8243,8215,28,21,74
Myiopsitta_monachus,8265,8201,64,12,61
Melopsittacus_undulatus,8233,8120,113,13,92
Pezoporus_wallicus,8256,8214,42,17,65
Psittacula_echo,8265,8249,16,12,61
Psittacula_krameri,8167,8073,94,73,98
Cacatua_sanguinea,8199,8181,18,53,86
Strigops_habroptila,8265,8168,97,10,63
Actenoides_hombroni,8040,8032,8,149,149
Todiramphus_albicilla,8216,8207,9,51,71
Todiramphus_chloris_collaris,8211,8068,143,43,84
Halcyon_senegalensis,8209,8201,8,35,94
Bucco_capensis,7661,7631,30,264,413
Galbula_dea,8122,8116,6,87,129
Colaptes_auratus,7848,7284,564,81,409
Dryobates_pubescens,8210,8185,25,16,112
Melanerpes_aurifrons,8240,8163,77,12,86
Melanerpes_formicivorus,7770,7718,52,39,529
Indicator_indicator,8127,8109,18,32,179
Indicator_maculatus,7851,7840,11,181,306
Pogoniulus_pusillus,8204,8188,16,18,116
Tricholaema_leucomelas,7731,7707,24,258,349
Psilopogon_haemacephalus,7734,7714,20,226,378
Buceros_bicornis,8205,8193,12,47,86
Bucorvus_abyssinicus,8227,8188,39,17,94
Rhinopomastus_cyanomelas,7755,7720,35,211,372
Upupa_epops,7655,7631,24,269,414
Trogon_melanurus,8004,7978,26,94,240
Trogon_surrucura,8271,8239,32,13,54
Apus_apus,8236,8221,15,19,83
Hemiprocne_comata,8254,8237,17,16,68
Archilochus_colubris,8228,8177,51,16,94
Calypte_anna,8150,8128,22,28,160
Phaethornis_superciliosus,8201,8191,10,24,113
Podargus_strigoides,8253,8082,171,16,69
Alopecoenas_beccarii,7877,7856,21,178,283
Caloenas_nicobarica,7922,7920,2,36,380
Columba_guinea,8274,8255,19,14,50
Columba_livia,8232,8222,10,40,66
Nesoenas_mayeri,8257,8231,26,17,64
Streptopelia_turtur,8174,7973,201,19,145
Patagioenas_fasciata_monilis,8182,8176,6,72,84
Centropus_bengalensis,7764,7745,19,206,368
Centropus_unirufus,8160,8151,9,62,116
Cuculus_canorus,8263,8239,24,16,59
Phaenicophaeus_curvirostris,8207,8137,70,18,113
Crotophaga_sulcirostris,8194,8189,5,46,98
Pterocles_burchelli,7968,7938,30,122,248
Pterocles_orientalis,8089,8065,24,90,159
Urocolius_indicus,7779,7754,25,246,313
Aix_galericulata,8248,8239,9,18,72
Cairina_moschata,8139,8035,104,52,147
Anas_bernieri,8245,8235,10,25,68
Anas_georgica,8159,8156,3,89,90
Anas_platyrhynchos,8270,8188,82,10,58
Anas_zonorhyncha,8186,8043,143,65,87
Anas_capensis,7982,7977,5,177,179
Spatula_discors,8114,8108,6,115,109
Spatula_querquedula,8074,8059,15,88,176
Lophonetta_specularioides,8241,8237,4,29,68
Tachyeres_brachypterus,8182,8177,5,72,84
Speculanas_specularis,8236,8234,2,35,67
Asarcornis_scutulata,8237,8220,17,35,66
Aythya_baeri,8276,8260,16,12,50
Aythya_fuligula,8268,8243,25,8,62
Aythya_marila,8281,8262,19,8,49
Melanitta_fusca,8161,8056,105,81,96
Somateria_mollissima,7693,7678,15,15,630
Anser_brachyrhynchus,8261,8254,7,22,55
Anser_cygnoides,8262,8251,11,23,53
Anser_indicus,8268,8251,17,13,57
Branta_canadensis,8260,8246,14,21,57
Branta_hutchinsii,7830,7822,8,230,278
Cygnus_atratus,8271,8256,15,12,55
Cygnus_olor,8266,8246,20,12,60
Cygnus_buccinator,8164,8136,28,29,145
Heteronetta_atricapilla,8256,8141,115,23,59
Oxyura_jamaicensis,8260,8170,90,21,57
Stictonetta_naevosa,8246,8131,115,29,63
Nettapus_auritus,8262,8203,59,20,56
Anseranas_semipalmata,8051,8028,23,101,186
Alectoris_magna,8261,8244,17,11,66
Alectoris_rufa,8266,7545,721,8,64
Coturnix_japonica,8251,8237,14,12,75
Gallus_gallus,8273,8253,20,9,56
Pavo_cristatus,8245,8217,28,11,82
Pavo_muticus,8239,8198,41,36,63
Centrocercus_minimus,8106,8087,19,38,194
Centrocercus_urophasianus,8187,8168,19,42,109
Tympanuchus_cupido_pinnatus,8208,8183,25,46,84
Tympanuchus_pallidicinctus,8246,8236,10,12,80
Lagopus_leucura,8221,8185,36,31,86
Lagopus_muta,8258,8242,16,11,69
Tetrao_urogallus,8250,8231,19,13,75
Chrysolophus_pictus,8120,8109,11,103,115
Crossoptilon_mantchuricum,8246,8235,11,24,68
Lophura_nycthemera,8250,8240,10,16,72
Lophura_swinhoii,8261,8240,21,13,64
Phasianus_colchicus,8248,8240,8,21,69
Syrmaticus_mikado,8228,8216,12,27,83
Callipepla_californica_brunnescens,8222,8201,21,15,101
Callipepla_squamata,8162,8093,69,59,117
Colinus_virginianus,8147,8140,7,38,153
Odontophorus_gujanensis,7905,7882,23,134,299
Numida_meleagris,8266,8258,8,18,54
Crax_fasciolata,8039,8035,4,171,128
Penelope_pileata,8217,8207,10,51,70
Anomalopteryx_didiformis,7892,7885,7,124,322
Crypturellus_cinnamomeus,8213,8203,10,30,95
Crypturellus_soui,8107,8093,14,86,145
Tinamus_major,8162,8151,11,76,100
Nothocercus_julius,8130,8121,9,63,145
Nothocercus_nigrocapillus,8082,8075,7,102,154
Eudromia_elegans,8206,8190,16,27,105
Nothoprocta_ornata,8165,8147,18,47,126
Nothoprocta_pentlandii,8150,8134,16,59,129
Nothoprocta_perdicaria,8212,8199,13,25,101
Nothura_maculosa,8085,8078,7,96,157
Apteryx_haastii,8242,8233,9,32,64
Apteryx_owenii,8246,8241,5,26,66
Apteryx_rowi,8239,8234,5,34,65
Casuarius_casuarius,8240,8222,18,23,75
Dromaius_novaehollandiae,8238,8227,11,30,70
Rhea_americana,8226,8219,7,31,81
Rhea_pennata,8257,8239,18,15,66
Struthio_camelus_australis,8197,8169,28,40,101
Alligator_mississippiensis,5220,5198,22,22,68
Alligator_sinensis,5091,5073,18,147,72
Caiman_crocodilus,5205,5195,10,54,51
Crocodylus_porosus,4995,4981,14,68,247
Gavialis_gangeticus,4919,4898,21,72,319
Actinemys_marmorata,5171,5110,61,20,119
Actinemys_pallida,5259,5232,27,23,28
Emys_orbicularis,5254,5233,21,21,35
Terrapene_carolina_triunguis,5123,4579,544,116,71
Glyptemys_insculpta,5142,5083,59,34,134
Chrysemys_picta_bellii,5197,5181,16,73,40
Malaclemys_terrapin_pileata,5254,5226,28,25,31
Trachemys_scripta_elegans,5094,5073,21,79,137
Platysternon_megacephalum,5239,5209,30,35,36
Aldabrachelys_gigantea,5259,5234,25,28,23
Chelonoidis_abingdonii,5036,5002,34,142,132
Gopherus_agassizii,4862,4826,36,188,260
Gopherus_evgoodei,5246,5187,59,27,37
Gopherus_flavomarginatus,5217,5189,28,41,52
Cuora_mccordi,5118,5004,114,120,72
Mauremys_mutica,5247,5156,91,32,31
Mauremys_reevesii,5258,5214,44,21,31
Caretta_caretta,5197,5182,15,20,93
Eretmochelys_imbricata,5261,5240,21,13,36
Chelonia_mydas,5257,5241,16,15,38
Dermochelys_coriacea,5211,5197,14,31,68
Chelydra_serpentina,5113,4914,199,82,115
Dermatemys_mawii,5218,5123,95,50,42
Sternotherus_odoratus,5059,5033,26,27,224
Carettochelys_insculpta,5195,4845,350,61,54
Pelochelys_cantorii,5179,5167,12,24,107
Pelodiscus_sinensis,5025,4998,27,141,144
Rafetus_swinhoei,5251,5222,29,23,36
Emydura_macquarii_macquarii,5255,5238,17,19,36
Emydura_subglobosa,5243,5113,130,30,37
Mesoclemmys_tuberculata,5204,4957,247,57,49
Pelusios_castaneus,5195,5147,48,67,48
Podocnemis_expansa,5206,5155,51,48,56
Ahaetulla_prasina,5028,5009,19,50,232
Arizona_elegans,5176,5140,36,40,94
Pantherophis_alleghaniensis,5015,4973,42,124,171
Pantherophis_obsoletus,4941,4893,48,187,182
Pantherophis_guttatus,5111,4924,187,54,145
Pituophis_catenifer_annectens,4813,4777,36,43,454
Ptyas_mucosa,5010,4963,47,133,167
Masticophis_lateralis,4879,4846,33,43,388
Diadophis_punctatus_similis,5094,5047,47,39,177
Erythrolamprus_reginae,5082,4967,115,65,163
Thermophis_baileyi,5128,5093,35,87,95
Natrix_helvetica_helvetica,5161,5042,119,32,117
Natrix_natrix_natrix,5085,5021,64,97,128
Thamnophis_elegans,5072,4975,97,71,167
Thamnophis_sirtalis_fitchi,5159,5124,35,43,108
Bungarus_multicinctus,5116,5048,68,42,152
Hydrophis_curtus,5146,5028,118,51,113
Hydrophis_cyanocinctus,5159,5050,109,47,104
Notechis_scutatus,4850,4754,96,209,251
Pseudonaja_textilis,5043,4932,111,110,157
Laticauda_colubrina,5018,4999,19,125,167
Naja_naja,5023,4979,44,98,189
Azemiops_feae,5081,5004,77,89,140
Crotalus_adamanteus,4802,4747,55,238,270
Protobothrops_flavoviridis,4783,4750,33,268,259
Protobothrops_mucrosquamatus,4894,4822,72,219,197
Crotalus_oreganus_helleri,4901,4859,42,44,365
Crotalus_tigris,5152,5082,70,58,100
Daboia_siamensis,4665,4494,171,313,332
Vipera_latastei,5183,5156,27,37,90
Vipera_ursinii,5139,5100,39,51,120
Charina_bottae,5212,5174,38,26,72
Liasis_olivaceus,5209,5191,18,34,67
Simalia_tracyae,4805,4790,15,284,221
Python_bivittatus,4646,4623,23,380,284
Anniella_stebbinsi,5235,5211,24,33,42
Elgaria_multicarinata_webbii,5236,5211,25,26,48
Heloderma_charlesbogerti,5000,4902,98,114,196
Shinisaurus_crocodilurus,5239,4886,353,28,43
Varanus_komodoensis,5174,5153,21,55,81
Varanus_salvator_macromaculatus,5139,4698,441,41,130
Anolis_apletophallus,5172,5117,55,54,84
Anolis_sagrei_ordinatus,5205,5139,66,42,63
Anolis_carolinensis,4848,4818,30,203,259
Cyclura_pinguis,5225,5193,32,36,49
Iguana_delicatissima,4688,4655,33,229,393
Gambelia_wislizenii,5230,5206,24,39,41
Phrynosoma_blainvillii,4699,4660,39,34,577
Phrynosoma_platyrhinos,4917,4895,22,218,175
Sceloporus_occidentalis,5295,1318,3977,3,12
Sceloporus_tristichus,5149,5069,80,88,73
Sceloporus_undulatus,5136,5051,85,89,85
Furcifer_pardalis,5234,5218,16,29,47
Phrynocephalus_forsythii,5199,5159,40,30,81
Phrynocephalus_versicolor,4970,4919,51,161,179
Pogona_vitticeps,5186,5167,19,84,40
Aspidoscelis_marmoratus,5196,5180,16,39,75
Salvator_merianae,5232,5211,21,25,53
Calyptommatus_sinebrachiatus,4950,4926,24,184,176
Tretioscincus_oriximinensis,5119,5088,31,96,95
Darevskia_unisexualis,5155,5098,57,35,120
Darevskia_valentini,4993,4869,124,179,138
Lacerta_agilis,5225,5140,85,29,56
Lacerta_bilineata,4900,4811,89,201,209
Lacerta_viridis,5042,4942,100,114,154
Zootoca_vivipara,5231,5183,48,33,46
Podarcis_cretensis,5249,5206,43,23,38
Podarcis_raffonei,5242,5187,55,29,39
Podarcis_lilfordi,5234,5185,49,31,45
Podarcis_muralis,5169,5070,99,48,93
Rhineura_floridana,5232,5167,65,32,46
Cryptoblepharus_egeriae,5204,5149,55,45,61
Lerista_edwardsae,4992,4810,182,176,142
Plestiodon_gilberti_rubricaudatus,5244,5217,27,25,41
Hemicordylus_capensis,5246,5200,46,27,37
Eublepharis_macularius,5247,5174,73,24,39
Euleptes_europaea,5249,5205,44,28,33
Sphaerodactylus_townsendi,4943,4907,36,141,226
Gekko_gecko,5246,5196,50,30,34
Gekko_japonicus,4863,4801,62,294,153
Lepidodactylus_listeri,5252,5188,64,25,33
Heteronotia_binoei,5223,5079,144,41,46
Paroedura_picta,4773,4741,32,323,214
Sphenodon_punctatus,5173,5113,60,65,72
Acinonyx_jubatus,9075,9047,28,76,75
Puma_concolor,8153,8121,32,411,662
Puma_yagouaroundi,8979,8927,52,129,118
Felis_catus,9067,9032,35,78,81
Felis_nigripes,9066,9031,35,70,90
Felis_chaus,9076,9032,44,71,79
Prionailurus_bengalensis,9072,9034,38,79,75
Prionailurus_viverrinus,9066,9026,40,83,77
Otocolobus_manul,9070,9006,64,81,75
Lynx_canadensis,8973,8934,39,98,155
Lynx_rufus,9084,9042,42,75,67
Leopardus_geoffroyi,9059,9024,35,81,86
Caracal_caracal,8909,8883,26,167,150
Neofelis_diardi,8923,8862,61,174,129
Neofelis_nebulosa,9078,9021,57,78,70
Panthera_leo,8864,8811,53,78,284
Panthera_pardus,9061,9013,48,79,86
Panthera_onca,8612,8569,43,326,288
Panthera_tigris,9070,9034,36,76,80
Panthera_uncia,8937,8774,163,142,147
Lynx_pardinus,8201,8158,43,353,672
Crocuta_crocuta,8893,8842,51,175,158
Hyaena_hyaena,9016,8960,56,108,102
Proteles_cristata_cristata,8531,8475,56,236,459
Cryptoprocta_ferox,8901,8817,84,174,151
Mungos_mungo,8142,8036,106,534,550
Suricata_suricatta,8908,8783,125,161,157
Paguma_larvata,9078,8947,131,72,76
Ailuropoda_melanoleuca,8970,8913,57,117,139
Helarctos_malayanus,8800,8766,34,212,214
Ursus_americanus,9041,9012,29,84,101
Ursus_arctos,8964,8916,48,69,193
Ursus_maritimus,9067,9022,45,76,83
Ursus_thibetanus_thibetanus,9035,8903,132,90,101
Tremarctos_ornatus,8955,8905,50,136,135
Ailurus_styani,8837,8730,107,222,167
Eira_barbara,9066,8992,74,79,81
Gulo_gulo,7953,7921,32,613,660
Gulo_gulo_luscus,9086,9042,44,70,70
Martes_flavigula,9080,9030,50,74,72
Martes_martes,9058,9020,38,86,82
Martes_zibellina,8940,8882,58,133,153
Enhydra_lutris_kenyoni,9076,8987,89,70,80
Enhydra_lutris_nereis,8620,8489,131,311,295
Lutra_lutra,9074,8879,195,69,83
Lontra_canadensis,9035,8869,166,93,98
Mustela_erminea,9043,8921,122,63,120
Mustela_eversmannii,9039,8893,146,87,100
Mustela_nigripes,9042,8849,193,87,97
Mustela_putorius,8844,8717,127,195,187
Mustela_putorius_furo,9061,8913,148,68,97
Mustela_lutreola,9082,8931,151,65,79
Mustela_nivalis,9028,8870,158,98,100
Neogale_vison,9067,8911,156,74,85
Meles_meles,9085,8949,136,75,66
Nasua_narica,8452,8385,67,368,406
Potos_flavus,8578,8539,39,334,314
Spilogale_interrupta,9055,8994,61,84,87
Arctocephalus_gazella,8765,8635,130,147,314
Arctocephalus_townsendi,8848,8576,272,201,177
Eumetopias_jubatus,9018,8673,345,110,98
Zalophus_californianus,9074,8779,295,76,76
Callorhinus_ursinus,9073,7822,1251,82,71
Odobenus_rosmarus_divergens,9032,8774,258,97,97
Halichoerus_grypus,8581,8413,168,238,407
Phoca_vitulina,9068,8908,160,81,77
Pusa_hispida_saimensis,9037,8892,145,100,89
Pusa_sibirica,8482,8354,128,345,399
Mirounga_angustirostris,8904,8713,191,185,137
Mirounga_leonina,9056,8765,291,86,84
Neomonachus_schauinslandi,9044,8856,188,89,93
Canis_lupus,9078,8926,152,80,68
Lycaon_pictus,8093,7960,133,131,1002
Chrysocyon_brachyurus,8957,8843,114,150,119
Nyctereutes_procyonoides,9064,8825,239,86,76
Vulpes_corsac,9076,8917,159,74,76
Vulpes_ferrilata,9073,8915,158,76,77
Vulpes_vulpes,8957,8804,153,140,129
Vulpes_lagopus,9042,8870,172,81,103
Urocyon_cinereoargenteus,9052,8929,123,87,87
Otocyon_megalotis_megalotis,8511,8334,177,299,416
Manis_javanica,8867,8722,145,154,205
Manis_pentadactyla,9021,8865,156,76,129
Phataginus_tricuspis,8736,8593,143,241,249
Addax_nasomaculatus,8699,8571,128,248,279
Oryx_dammah,9050,8696,354,89,87
Hippotragus_equinus,8934,8775,159,155,137
Hippotragus_niger_niger,9019,8867,152,104,103
Budorcas_taxicolor,9080,8848,232,72,74
Ovibos_moschatus,9017,8825,192,103,106
Capra_aegagrus,8359,8209,150,426,441
Capra_hircus,9035,8858,177,102,89
Capra_sibirica,9040,8863,177,97,89
Ovis_ammon,8714,8557,157,248,264
Ovis_aries,9074,8853,221,74,78
Ovis_orientalis,9071,8821,250,78,77
Ovis_nivicola_lydekkeri,8970,8767,203,125,131
Oreamnos_americanus,8478,8352,126,345,403
Pantholops_hodgsonii,8680,8495,185,285,261
Kobus_leche_leche,8777,8587,190,241,208
Ammotragus_lervia,8699,8553,146,209,318
Connochaetes_taurinus,8307,8194,113,415,504
Damaliscus_lunatus,8536,8309,227,309,381
Oryx_gazella,8384,8250,134,353,489
Cephalophus_harveyi,7990,7841,149,602,634
Kobus_ellipsiprymnus,8394,8204,190,384,448
Eudorcas_thomsonii,8634,8455,179,243,349
Litocranius_walleri,8922,8622,300,159,145
Nanger_dama,9048,8875,173,85,93
Procapra_przewalskii,8599,8491,108,312,315
Bison_bison_bison,8615,8450,165,284,327
Bos_grunniens,8851,8689,162,75,300
Bos_gaurus,9068,8864,204,81,77
Bos_indicus,8551,8357,194,179,496
Bos_taurus,9077,8895,182,77,72
Bubalus_bubalis,9030,8863,167,83,113
Bubalus_carabanensis,9076,8902,174,76,74
Syncerus_caffer,9035,8884,151,95,96
Tragelaphus_eurycerus,9061,8817,244,88,77
Bos_frontalis,8188,7197,991,497,541
Bos_mutus,8501,8395,106,324,401
Tragelaphus_strepsiceros,7823,7646,177,663,740
Moschus_berezovskii,8977,8712,265,90,159
Moschus_moschiferus,9037,8781,256,96,93
Alces_alces,8991,8855,136,117,118
Odocoileus_hemionus,8918,8597,321,88,220
Odocoileus_virginianus,8916,8606,310,87,223
Rangifer_tarandus,9041,8738,303,84,101
Capreolus_capreolus,9068,8768,300,73,85
Capreolus_pygargus,8939,8684,255,144,143
Hydropotes_inermis,9016,8822,194,110,100
Axis_porcinus,9014,8731,283,111,101
Cervus_albirostris,8727,8448,279,275,224
Cervus_canadensis,8960,8651,309,92,174
Cervus_hanglu_yarkandensis,9028,8612,416,97,101
Cervus_elaphus,9066,8752,314,78,82
Elaphurus_davidianus,8253,8083,170,453,520
Dama_dama,9061,8742,319,78,87
Muntiacus_crinifrons,9028,8832,196,99,99
Muntiacus_gongshanensis,8611,8419,192,118,497
Muntiacus_muntjak,8981,8796,185,126,119
Muntiacus_reevesi,9043,8857,186,92,91
Antilocapra_americana,9025,8648,377,105,96
Giraffa_camelopardalis,8962,8858,104,151,113
Giraffa_tippelskirchi,9015,8910,105,116,95
Okapia_johnstoni,8978,8882,96,109,139
Tragulus_javanicus,8986,8736,250,121,119
Tragulus_kanchil,8880,8600,280,102,244
Balaenoptera_acutorostrata,9036,8785,251,92,98
Balaenoptera_musculus,9045,8816,229,78,103
Balaenoptera_ricei,9031,8797,234,77,118
Eschrichtius_robustus,9066,8851,215,72,88
Balaenoptera_physalus,8861,8627,234,208,157
Megaptera_novaeangliae,8928,8815,113,142,156
Eubalaena_glacialis,9062,8792,270,73,91
Delphinapterus_leucas,9001,8810,191,102,123
Monodon_monoceros,9008,8836,172,92,126
Neophocaena_asiaeorientalis_asiaeorientalis,8910,8779,131,155,161
Phocoena_sinus,9005,8858,147,92,129
Delphinus_delphis,8985,8798,187,102,139
Stenella_coeruleoalba,8988,8813,175,95,143
Tursiops_truncatus,8991,8783,208,103,132
Sousa_chinensis,8993,8793,200,105,128
Globicephala_melas,9001,8788,213,93,132
Grampus_griseus,8693,8502,191,277,256
Steno_bredanensis,8808,8647,161,204,214
Lagenorhynchus_obliquidens,9001,8809,192,100,125
Orcinus_orca,9017,8811,206,95,114
Lagenorhynchus_albirostris,8987,8784,203,111,128
Tursiops_aduncus,8612,8340,272,243,371
Lipotes_vexillifer,8965,8811,154,131,130
Hyperoodon_ampullatus,8979,8754,225,102,145
Mesoplodon_densirostris,9003,8742,261,87,136
Kogia_breviceps,8976,8826,150,96,154
Physeter_catodon,8733,8532,201,276,217
Hexaprotodon_liberiensis,8927,8550,377,87,212
Hippopotamus_amphibius,8997,8683,314,127,102
Babyrousa_celebensis,8284,8230,54,462,480
Phacochoerus_africanus,9071,9049,22,85,70
Sus_cebifrons,9040,9006,34,101,85
Sus_scrofa,9052,9012,40,89,85
Catagonus_wagneri,9011,8979,32,114,101
Camelus_bactrianus,8906,8860,46,189,131
Camelus_ferus,9028,8976,52,86,112
Camelus_dromedarius,9067,9006,61,80,79
Lama_glama,8697,8476,221,256,273
Lama_guanicoe_cacsilensis,9057,9002,55,85,84
Vicugna_pacos,8918,8865,53,173,135
Vicugna_vicugna_mensalis,9032,8987,45,103,91
Ceratotherium_simum_cottoni,9063,9001,62,82,81
Diceros_bicornis,8854,8815,39,189,183
Diceros_bicornis_minor,9100,9049,51,59,67
Diceros_bicornis_michaeli,9082,9041,41,62,82
Rhinoceros_unicornis,8843,8382,461,198,185
Dicerorhinus_sumatrensis_harrissoni,9039,9014,25,84,103
Tapirus_indicus,9069,9042,27,77,80
Equus_asinus,9073,9016,57,75,78
Equus_asinus_asinus,8983,8943,40,119,124
Equus_quagga,9065,8755,310,79,82
Equus_caballus,9070,8949,121,81,75
Equus_przewalskii,8017,7959,58,585,624
Aeorestes_cinereus,8733,8418,315,203,290
Corynorhinus_townsendii,8846,8606,240,95,285
Plecotus_auritus,9050,8881,169,89,87
Antrozous_pallidus,9001,8728,273,80,145
Eptesicus_fuscus,9069,8963,106,77,80
Eptesicus_nilssonii,8991,8888,103,81,154
Ia_io,9054,8934,120,83,89
Pipistrellus_kuhlii,9012,8896,116,93,121
Pipistrellus_pipistrellus,8457,8340,117,141,628
Pipistrellus_pygmaeus,9036,8946,90,72,118
Myotis_brandtii,8514,8278,236,340,372
Myotis_lucifugus,8319,7982,337,298,609
Myotis_yumanensis,8836,8512,324,89,301
Myotis_daubentonii,9055,8794,261,69,102
Myotis_myotis,9052,8795,257,80,94
Myotis_davidii,8439,8284,155,361,426
Miniopterus_natalensis,8843,8793,50,207,176
Miniopterus_schreibersii,7827,7756,71,701,698
Molossus_alvarezi,9029,8803,226,87,110
Molossus_molossus,9032,8927,105,82,112
Molossus_nigricans,9042,8930,112,80,104
Tadarida_brasiliensis,9068,8926,142,75,83
Anoura_caudifer,8100,8024,76,494,632
Artibeus_jamaicensis,9037,8998,39,74,115
Sturnira_hondurensis,8709,8672,37,102,415
Phyllostomus_discolor,8992,8936,56,90,144
Phyllostomus_hastatus,9048,9004,44,71,107
Trachops_cirrhosus,8440,8390,50,372,414
Desmodus_rotundus,8977,8907,70,81,168
Mormoops_blainvillei,7978,7932,46,580,668
Pteronotus_parnellii_mesoamericanus,9050,8955,95,83,93
Rhynchonycteris_naso,9010,8907,103,92,124
Cynopterus_sphinx,9052,9017,35,72,102
Eidolon_dupreanum,8148,8118,30,393,685
Macroglossus_sobrinus,8405,8375,30,333,488
Pteropus_pselaphon,8606,8582,24,242,378
Pteropus_alecto,8995,8987,8,110,121
Pteropus_giganteus,8967,8946,21,107,152
Pteropus_rufus,8864,8847,17,164,198
Pteropus_vampyrus,8685,8650,35,274,267
Eonycteris_spelaea,9014,8987,27,83,129
Rousettus_aegyptiacus,9071,9061,10,75,80
Rousettus_leschenaultii,9062,9053,9,81,83
Rousettus_madagascariensis,7984,7956,28,491,751
Hipposideros_armiger,8626,8506,120,264,336
Hipposideros_pendleburyi,8979,8837,142,124,123
Hipposideros_larvatus,9084,8933,151,72,70
Rhinolophus_ferrumequinum,9077,8960,117,73,76
Rhinolophus_sinicus,9031,8979,52,110,85
Megaderma_lyra,8135,8046,89,498,593
Condylura_cristata,8444,8421,23,221,561
Talpa_occidentalis,9019,8810,209,85,122
Galemys_pyrenaicus,8994,8947,47,107,125
Erinaceus_europaeus,8911,8785,126,140,175
Sorex_araneus,8991,8882,109,77,158
Sorex_fumeus,9019,8912,107,74,133
Suncus_etruscus,8907,8701,206,91,228
Solenodon_paradoxus,8324,8304,20,374,528
Acomys_cahirinus,9072,8987,85,61,93
Acomys_dimidiatus,8889,8650,239,149,188
Acomys_kempi,8750,8700,50,122,354
Acomys_percivali,8936,8795,141,125,165
Acomys_russatus,9038,8917,121,78,110
Meriones_unguiculatus,9027,8958,69,84,115
Rhombomys_opimus,8923,8842,81,106,197
Psammomys_obesus,8868,8802,66,155,203
Pachyuromys_duprasi,8762,8638,124,197,267
Lophiomys_imhausi,8836,8701,135,186,204
Apodemus_sylvaticus,9052,8998,54,58,116
Tokudaia_osimensis,9034,8980,54,84,108
Mastomys_coucha,8978,8852,126,105,143
Mus_caroli,9008,8828,180,89,129
Mus_musculus,9073,8840,233,67,86
Mus_spicilegus,8907,8704,203,144,175
Mus_spretus,9075,8868,207,70,81
Mus_pahari,9023,8900,123,76,127
Mus_minutoides,8427,8243,184,341,458
Arvicanthis_niloticus,9038,8863,175,73,115
Rhabdomys_dilectus,8228,8075,153,195,803
Rhabdomys_pumilio,8981,8795,186,114,131
Mastomys_natalensis,8312,8134,178,329,585
Grammomys_surdaster,8967,8679,288,120,139
Rhynchomys_soricoides,8571,8468,103,115,540
Uromys_caudimaculatus,8826,8650,176,179,221
Rattus_norvegicus,9068,8882,186,68,90
Rattus_rattus,8843,8719,124,98,285
Arvicola_amphibius,9063,8892,171,62,101
Chionomys_nivalis,9079,8854,225,64,83
Microtus_agrestis,9027,8747,280,95,104
Microtus_californicus,9068,8721,347,68,90
Microtus_ochrogaster,9001,8849,152,87,138
Microtus_oregoni,9073,7926,1147,63,90
Microtus_fortis,8970,8794,176,97,159
Neodon_shergylaensis,8876,8556,320,171,179
Microtus_richardsoni_arvicoloides,8300,7843,457,405,521
Ellobius_lutescens,7729,7624,105,677,820
Myodes_glareolus,8788,8668,120,122,316
Dicrostonyx_torquatus,8656,8614,42,212,358
Cricetulus_griseus,8249,8146,103,389,588
Mesocricetus_auratus,9057,8944,113,80,89
Phodopus_roborovskii,9047,8826,221,73,106
Phodopus_sungorus,9080,9049,31,68,78
Onychomys_arenicola,8981,8918,63,79,166
Onychomys_leucogaster,8950,8895,55,74,202
Onychomys_torridus,8885,8822,63,124,217
Peromyscus_californicus_insignis,9061,8905,156,67,98
Peromyscus_eremicus,8905,8802,103,126,195
Peromyscus_leucopus,8930,8671,259,78,218
Peromyscus_maniculatus_bairdii,9028,8917,111,99,99
Peromyscus_polionotus_subgriseus,9016,8904,112,99,111
Phyllotis_vaccarum,9015,8992,23,82,129
Cricetomys_ansorgei,9060,8139,921,77,89
Nannospalax_galili,8956,8877,79,155,115
Rhizomys_pruinosus,8611,8184,427,239,376
Typhlomys_cinereus,8950,8452,498,110,166
Jaculus_jaculus,8977,8587,390,90,159
Castor_canadensis,7941,7773,168,532,753
Dipodomys_merriami,9013,7266,1747,81,132
Dipodomys_spectabilis,9004,8883,121,87,135
Dipodomys_ordii,8591,8506,85,302,333
Perognathus_longimembris,8944,8180,764,74,208
Thomomys_bottae,8705,8591,114,71,450
Cavia_porcellus,8903,8804,99,137,186
Hydrochoerus_hydrochaeris,8136,8050,86,475,615
Coendou_prehensilis,7903,7813,90,513,810
Erethizon_dorsatum,9074,8922,152,78,74
Chinchilla_lanigera,8963,8906,57,133,130
Octodon_degus,8950,8419,531,126,150
Fukomys_damarensis,8719,8655,64,224,283
Heterocephalus_glaber,8983,8639,344,93,150
Hystrix_brachyura,8965,8903,62,115,146
Ctenodactylus_gundi,8417,8378,39,332,477
Cynomys_gunnisoni,8660,8382,278,234,332
Spermophilus_dauricus,8329,8088,241,406,491
Marmota_himalayana,8483,8320,163,215,528
Marmota_vancouverensis,8164,8006,158,509,553
Marmota_flaviventris,9037,8831,206,93,96
Marmota_monax,9061,8768,293,83,82
Marmota_marmota_marmota,8908,8744,164,167,151
Ictidomys_tridecemlineatus,8919,8822,97,133,174
Urocitellus_parryii,8881,8804,77,138,207
Tamias_sibiricus,8867,8744,123,106,253
Xerus_rutilus,8562,8449,113,339,325
Glaucomys_volans,8428,8240,188,341,457
Sciurus_carolinensis,9065,8867,198,78,83
Sciurus_vulgaris,9080,8569,511,82,64
Muscardinus_avellanarius,9016,8862,154,95,115
Lepus_europaeus,9048,8798,250,73,105
Lepus_timidus,8186,8059,127,400,640
Lepus_townsendii,8832,8520,312,183,211
Oryctolagus_cuniculus,8794,8393,401,100,332
Sylvilagus_bachmani,8721,8560,161,234,271
Sylvilagus_floridanus,9045,8918,127,66,115
Ochotona_curzoniae,9033,8407,626,73,120
Ochotona_princeps,8988,8823,165,72,166
Tupaia_chinensis,8926,8765,161,160,140
Tupaia_tana,9058,8758,300,67,101
Aotus_nancymaae,9026,8764,262,104,96
Callithrix_jacchus,9058,8754,304,80,88
Leontopithecus_rosalia,8630,8389,241,316,280
Saguinus_midas,8903,8564,339,118,205
Saguinus_oedipus,9042,8600,442,77,107
Cebus_albifrons,8990,8760,230,100,136
Cebus_imitator,8962,8754,208,140,124
Sapajus_apella,8985,8747,238,129,112
Saimiri_boliviensis_boliviensis,9056,8862,194,85,85
Ateles_geoffroyi,9028,8840,188,102,96
Ateles_hybridus,9058,8877,181,80,88
Pithecia_pithecia,9037,8806,231,96,93
Cercocebus_atys,9007,8845,162,101,118
Mandrillus_leucophaeus,8758,8590,168,270,198
Mandrillus_sphinx,8906,8776,130,91,229
Lophocebus_aterrimus,8990,8819,171,121,115
Papio_anubis,8827,8555,272,119,280
Papio_hamadryas,8992,8817,175,100,134
Theropithecus_gelada,8988,8780,208,136,102
Macaca_arctoides,8894,8741,153,184,148
Macaca_assamensis,9012,8859,153,93,121
Macaca_thibetana_thibetana,9055,8900,155,94,77
Macaca_cyclopis,9063,8908,155,81,82
Macaca_mulatta,9069,8881,188,80,77
Macaca_fascicularis,9067,8913,154,82,77
Macaca_nemestrina,9032,8880,152,98,96
Macaca_silenus,9000,8838,162,100,126
Macaca_nigra,9062,8901,161,87,77
Cercopithecus_albogularis,8955,8767,188,96,175
Cercopithecus_mona,8888,8705,183,99,239
Miopithecus_talapoin,8795,8630,165,229,202
Chlorocebus_aethiops,8993,8808,185,104,129
Chlorocebus_sabaeus,9039,8856,183,82,105
Erythrocebus_patas,8918,8719,199,115,193
Papio_papio,7664,7446,218,725,837
Colobus_angolensis_palliatus,8839,8618,221,203,184
Colobus_guereza,8967,8737,230,115,144
Piliocolobus_tephrosceles,8894,8599,295,187,145
Pygathrix_nigripes,8869,8665,204,135,222
Rhinopithecus_roxellana,9040,8748,292,101,85
Rhinopithecus_strykeri,8874,8640,234,123,229
Trachypithecus_francoisi,9000,8761,239,85,141
Trachypithecus_phayrei_crepuscula,8822,8629,193,157,247
Rhinopithecus_bieti,8439,8253,186,360,427
Gorilla_gorilla_gorilla,9071,8871,200,88,67
Homo_sapiens,9074,8622,452,81,71
Pan_paniscus,9071,8863,208,79,76
Pan_troglodytes,9078,8865,213,79,69
Pongo_abelii,9058,8865,193,80,88
Pongo_pygmaeus,9059,8865,194,78,89
Hoolock_leuconedys,8852,8691,161,137,237
Hylobates_moloch,8928,8646,282,152,146
Hylobates_pileatus,8902,8714,188,104,220
Symphalangus_syndactylus,8627,8172,455,82,517
Nomascus_leucogenys,9027,8821,206,105,94
Nomascus_siki,8907,8755,152,123,196
Carlito_syrichta,7983,7752,231,554,689
Cephalopachus_bancanus,8891,8746,145,137,198
Cheirogaleus_medius,8325,8238,87,349,552
Microcebus_murinus,9024,8763,261,95,107
Propithecus_coquereli,8724,8583,141,232,270
Eulemur_flavifrons,8459,8374,85,314,453
Eulemur_macaco,8501,8422,79,318,407
Lemur_catta,8999,8908,91,79,148
Prolemur_simus,8918,8827,91,165,143
Varecia_variegata,8231,8094,137,485,510
Daubentonia_madagascariensis,9039,8987,52,90,97
Galago_moholi,8379,8113,266,364,483
Otolemur_garnettii,8977,8770,207,107,142
Loris_tardigradus,9031,8757,274,77,118
Nycticebus_bengalensis,8924,8543,381,107,195
Nycticebus_coucang,9060,8629,431,79,87
Cynocephalus_volans,9061,8893,168,81,84
Galeopterus_variegatus,8108,7931,177,522,596
Choloepus_didactylus,8972,8454,518,105,149
Choloepus_hoffmanni,8150,7679,471,490,586
Tamandua_tetradactyla,8998,8556,442,105,123
Dasypus_novemcinctus,8935,8687,248,98,193
Tolypeutes_matacus,8973,8331,642,118,135
Chrysochloris_asiatica,8998,8837,161,110,118
Echinops_telfairi,8667,8518,149,220,339
Elephantulus_edwardii,8928,8271,657,112,186
Orycteropus_afer_afer,8883,8825,58,165,178
Dugong_dugon,9061,8999,62,82,83
Trichechus_manatus_latirostris,8914,8860,54,134,178
Elephas_maximus,9039,8982,57,72,115
Loxodonta_africana,8836,8786,50,175,215
Heterohyrax_brucei,9018,8976,42,85,123
Procavia_capensis,8516,8460,56,264,446
Antechinus_flavipes,8752,8639,113,89,385
Antechinus_stuartii,8775,8615,160,129,322
Dasyurus_viverrinus,8893,8799,94,89,244
Sarcophilus_harrisii,8734,8633,101,121,371
Thylacinus_cynocephalus,7999,7920,79,386,841
Bettongia_penicillata_ogilbyi,8895,8691,204,91,240
Potorous_gilbertii,7837,6888,949,457,932
Lagorchestes_hirsutus,8530,8304,226,257,439
Macropus_fuliginosus,8023,7893,130,477,726
Macropus_giganteus,8397,8258,139,322,507
Notamacropus_eugenii,8928,8694,234,81,217
Gymnobelideus_leadbeateri,8286,7514,772,348,592
Petaurus_breviceps_papuanus,8773,8248,525,131,322
Phalanger_gymnotis,7479,7163,316,585,1162
Trichosurus_vulpecula,8860,8531,329,85,281
Phascolarctos_cinereus,8958,8857,101,70,198
Vombatus_ursinus,8841,8028,813,127,258
Dromiciops_gliroides,8915,8639,276,82,229
Gracilinanus_agilis,8363,8152,211,305,558
Monodelphis_domestica,8747,8529,218,100,379
Ornithorhynchus_anatinus,8449,8377,72,149,628
Tachyglossus_aculeatus,8424,8372,52,140,662
Ambystoma_mexicanum,,,,,
Pleurodeles_waltl,,,,,
Bombina_bombina,4893,4673,220,153,264
Discoglossus_pictus,5040,4936,104,67,203
Bufo_bufo,4998,4901,97,86,226
Bufo_gargarizans,4830,4575,255,105,375
Bufotes_viridis,4930,4819,111,111,269
Rhinella_marina,4540,4436,104,275,495
Leptodactylus_fallax,5034,4961,73,76,200
Leptodactylus_fuscus,5011,4932,79,57,242
Ranitomeya_imitator,5020,4922,98,71,219
Dendropsophus_ebraccatus,5068,4880,188,51,191
Hyla_sarda,4915,4843,72,103,292
Pseudophryne_corroboree,4999,4917,82,75,236
Taudactylus_pleione,5026,4929,97,89,195
Gastrophryne_carolinensis,4983,4906,77,72,255
Glandirana_rugosa,4205,4107,98,502,603
Lithobates_sylvaticus,4774,4628,146,163,373
Rana_kukunoris,4950,4695,255,88,272
Rana_temporaria,4980,4869,111,71,259
Rana_muscosa,4661,4218,443,245,404
Staurois_parvus,4479,4428,51,331,500
Nanorana_parkeri,4770,4707,63,237,303
Pyxicephalus_adspersus,4874,4813,61,151,285
Leptobrachium_ailaonicum,4585,4485,100,151,574
Leptobrachium_leishanense,4937,4803,134,105,268
Pelobates_cultripes,4822,4648,174,157,331
Spea_bombifrons,5053,5003,50,50,207
Spea_hammondii,5038,4965,73,51,221
Hymenochirus_boettgeri,4792,4640,152,193,325
Xenopus_borealis,4726,3025,1701,241,343
Xenopus_laevis,5172,2391,2781,23,115
Xenopus_tropicalis,5123,5054,69,39,148
Geotrypetes_seraphini,5053,4953,100,59,198
Microcaecilia_unicolor,5071,4828,243,61,178
Rhinatrema_bivittatum,5100,4931,169,48,162
Neoceratodus_forsteri,,,,,
Latimeria_chalumnae,2980,2940,40,255,119
Abramis_brama,3597,3545,52,20,23
Vimba_vimba,3591,3558,33,24,25
Leucaspius_delineatus,3581,3540,41,20,39
Scardinius_erythrophthalmus,3579,3536,43,18,43
Squalius_cephalus,3572,3524,48,18,50
Rutilus_rutilus,3613,3547,66,19,8
Leuciscus_idus,3590,3549,41,22,28
Cyprinella_lepida,3461,3440,21,84,95
Cyprinella_venusta,3453,3432,21,100,87
Pimephales_promelas,3561,3424,137,44,35
Hybognathus_amarus,3411,3332,79,89,140
Rhinichthys_klamathensis_goyatoka,3433,3400,33,35,172
Rhinichthys_osculus,3607,3576,31,23,10
Tiaroga_cobitis,3611,3512,99,23,6
Gila_orcuttii,3605,3579,26,25,10
Meda_fulgida,3593,3566,27,27,20
Semotilus_atromaculatus,3605,3550,55,23,12
Phoxinus_phoxinus,3591,3570,21,21,28
Gobio_gobio,3582,3552,30,24,34
Gobio_occitaniae,3448,2891,557,103,89
Romanogobio_albipinnatus,3532,3493,39,24,84
Gobiocypris_rarus,3566,3471,95,28,46
Pseudorasbora_parva,3596,3567,29,26,18
Paracanthobrama_guichenoti,3571,3359,212,32,37
Anabarilius_grahami,3582,3562,20,42,16
Chanodichthys_erythropterus,3608,3580,28,20,12
Culter_alburnus,3572,3502,70,44,24
Megalobrama_amblycephala,3604,3561,43,27,9
Hypophthalmichthys_molitrix,3540,3517,23,58,42
Hypophthalmichthys_nobilis,3588,3561,27,17,35
Ctenopharyngodon_idella,3593,3492,101,21,26
Mylopharyngodon_piceus,3615,3575,40,17,8
Acrossocheilus_wenchowensis,3560,3224,336,28,52
Onychostoma_macrolepis,3592,3566,26,18,30
Aspiorhynchus_laticeps,3529,2488,1041,31,80
Schizothorax_lantsangensis,3575,3439,136,23,42
Gymnocypris_eckloni_scoliostomus,3500,3224,276,55,85
Schizopygopsis_pylzovi,3391,3304,87,46,203
Schizopygopsis_malacanthus,3512,3290,222,28,100
Oxygymnocypris_stewartii,3502,1721,1781,50,88
Ptychobarbus_kaznakovi,3305,3206,99,47,288
Barbus_barbus,3613,676,2937,22,5
Enteromius_argenteus,3484,3466,18,95,61
Enteromius_mattozi,3295,3272,23,235,110
Enteromius_radiatus,3488,3464,24,94,58
Enteromius_thamalakanensis,3367,3338,29,153,120
Enteromius_trimaculatus,3264,3230,34,237,139
Enteromius_unitaeniatus,3349,3327,22,186,105
Enteromius_treurensis,3356,3330,26,168,116
Puntigrus_tetrazona,3615,3411,204,18,7
Carassius_auratus,3611,1259,2352,20,9
Carassius_gibelio,3604,1536,2068,19,17
Carassius_carassius,3604,1579,2025,22,14
Cyprinus_carpio,3603,1312,2291,16,21
Cyprinus_carpio_carpio,3620,1127,2493,15,5
Sinocyclocheilus_anophthalmus,3480,1591,1889,68,92
Sinocyclocheilus_maitianheensis,3606,1378,2228,21,13
Sinocyclocheilus_grahami,3470,1951,1519,104,66
Sinocyclocheilus_anshuiensis,3603,1367,2236,19,18
Sinocyclocheilus_rhinocerous,3567,1531,2036,49,24
Cirrhinus_molitorella,3611,3587,24,22,7
Labeo_catla,3536,3480,56,53,51
Labeo_rohita,3611,3592,19,20,9
Danio_aesculapii,3534,3480,54,34,72
Danio_kyathit,3562,3512,50,23,55
Danio_rerio,3547,3517,30,54,39
Danionella_dracula,3360,3267,93,51,229
Danionella_translucida,3389,3316,73,93,158
Paedocypris_micromegethes,3441,3400,41,39,160
Paedocypris_sp_Pulau_Singkep,3236,3183,53,101,303
Barbatula_barbatula,3551,3521,30,21,68
Triplophysa_bombifrons,3565,3518,47,26,49
Triplophysa_dalaica,3529,3488,41,20,91
Triplophysa_tibetana,3575,3485,90,15,50
Triplophysa_siluroides,3563,3531,32,23,54
Triplophysa_rosa,3571,3541,30,22,47
Oreonectes_daqikongensis,3575,3517,58,18,47
Triplophysa_yarkandensis,3527,3418,109,36,77
Beaufortia_kweichowensis,3586,3550,36,22,32
Misgurnus_anguillicaudatus,3534,3450,84,20,86
Misgurnus_mizolepis,3566,3099,467,20,54
Paramisgurnus_dabryanus,3589,3530,59,18,33
Moxostoma_hubbsi,3616,1780,1836,15,9
Xyrauchen_texanus,3609,1776,1833,21,10
Myxocyprinus_asiaticus,3622,1421,2201,12,6
Ameiurus_melas,3594,3565,29,24,22
Prietella_phreatophila,3444,3390,54,99,97
Ictalurus_furcatus,3562,3527,35,17,61
Ictalurus_punctatus,3604,3580,24,12,24
Pylodictis_olivaris,3372,3239,133,155,113
Stegophilus_panzeri,3539,3299,240,60,41
Cranoglanis_bouderius,3606,3576,30,13,21
Pangasianodon_gigas,3572,3548,24,35,33
Pangasianodon_hypophthalmus,3611,3595,16,11,18
Pangasius_djambal,3523,3499,24,61,56
Ariopsis_seemanni,3213,3184,29,190,237
Potamarius_nelsoni,3216,3179,37,216,208
Potamarius_usumacintae,3212,3178,34,210,218
Sciades_herzbergii,3519,3493,26,54,67
Sciades_proops,3191,3155,36,200,249
Arius_madagascariensis,3234,3198,36,168,238
Cephalocassis_borneensis,3193,3158,35,200,247
Nemapteryx_nenga,3200,3168,32,200,240
Cephalocassis_melanochir,3161,3131,30,211,268
Cochlefelis_danielsi,3168,3125,43,214,258
Cochlefelis_spatula,3155,3120,35,218,267
Neoarius_graeffei,3569,3528,41,23,48
Netuma_bilineata,3216,3186,30,198,226
Aspistor_quadriscutis,3215,3175,40,192,233
Notarius_cookei,3229,3180,49,183,228
Notarius_kessleri,3226,3189,37,178,236
Notarius_lentiginosus,3223,3188,35,177,240
Genidens_machadoi,3172,3130,42,209,259
Genidens_planifrons,3501,3477,24,65,74
Bagre_pinnimaculatus,3508,3485,23,53,79
Gogo_arcuatus,3418,3395,23,119,103
Notoglanidium_macrostoma,3309,3280,29,170,161
Notoglanidium_maculatum,3282,3255,27,195,163
Parauchenoglanis_pantherinus,3303,3278,25,179,158
Parauchenoglanis_punctatus,3280,3249,31,205,155
Synodontis_membranacea,3252,3224,28,218,170
Neosilurus_mollespiculum,3477,3442,35,87,76
Plotosus_lineatus,3569,3537,32,26,45
Bagarius_yarrelli,3524,3494,30,35,81
Bagroides_melapterus,3277,3241,36,203,160
Tachysurus_fulvidraco,3589,3558,31,20,31
Tachysurus_vachellii,3601,3575,26,14,25
Hemibagrus_wyckioides,3588,3564,24,18,34
Channallabes_apus,3583,3540,43,16,41
Clariallabes_melas,3443,3417,26,80,117
Clariallabes_teugelsi,3562,3535,27,33,45
Clarias_pachynema,3553,3530,23,45,42
Clarias_angolensis,3558,3535,23,35,47
Clarias_buthupogon,3535,3513,22,51,54
Platyallabes_tihoni,3533,3514,19,51,56
Clarias_platycephalus,3563,3541,22,30,47
Clarias_gariepinus,3601,3568,33,17,22
Leiocassis_micropogon,3265,3226,39,208,167
Clarias_laeviceps,3548,3523,25,44,48
Clarias_batrachus,3357,3316,41,101,182
Clarias_magur,3550,3499,51,36,54
Clarias_fuscus,3588,3538,50,19,33
Kryptopterus_vitreolus,3326,3293,33,28,286
Silurus_aristotelis,3572,3545,27,26,42
Silurus_asotus,3524,3488,36,55,61
Silurus_meridionalis,3540,3512,28,19,81
Corydoras_maculifer,3276,3250,26,107,257
Corydoras_sp_C115,3482,3457,25,52,106
Trichomycterus_rosablanca,3574,3538,36,25,41
Astyanax_mexicanus,3616,3593,23,14,10
Salminus_brasiliensis,3575,3565,10,23,42
Colossoma_macropomum,3613,3598,15,20,7
Pygocentrus_nattereri,3618,3609,9,17,5
Megaleporinus_macrocephalus,3583,3560,23,24,33
Prochilodus_magdalenae,3510,3467,43,79,51
Hoplias_malabaricus,3563,3542,21,31,46
Hepsetus_odoe,3553,3487,66,56,31
Brachyhypopomus_occidentalis,3564,3550,14,19,57
Electrophorus_electricus,3599,3573,26,21,20
Electrophorus_voltai,3593,3572,21,26,21
Sternarchorhynchus_goeldii,3461,3441,20,99,80
Tenebrosternarchus_preto,3454,3434,20,114,72
Distichodus_sexfasciatus,3373,3320,53,114,153
Chanos_chanos,3604,3579,25,15,21
Alosa_alosa,3434,3387,47,45,161
Alosa_sapidissima,3569,3527,42,35,36
Sardinella_longiceps,3471,3244,227,53,116
Tenualosa_ilisha,3580,3041,539,26,34
Tenualosa_thibaudeaui,3585,3556,29,22,33
Clupea_harengus,3527,3420,107,58,55
Sprattus_sprattus,3572,3537,35,32,36
Coilia_nasus,3494,3445,49,37,109
Setipinna_tenuifilis,3384,3314,70,33,223
Denticeps_clupeoides,3538,3243,295,32,70
Acanthochromis_polyacanthus,3610,3584,26,17,13
Amphiprion_clarkii,3618,3608,10,15,7
Amphiprion_ocellaris,3597,3573,24,20,23
Amphiprion_percula,3617,3585,32,13,10
Dascyllus_trimaculatus,3592,3537,55,21,27
Stegastes_partitus,3578,3556,22,53,9
Brachyistius_frenatus,3607,3601,6,18,15
Embiotoca_jacksoni,3612,3602,10,18,10
Blennius_ocellaris,3553,3541,12,39,48
Lipophrys_pholis,3602,3593,9,24,14
Salarias_fasciatus,3572,3343,229,36,32
Malacoctenus_gilli,3386,3372,14,177,77
Gouania_willdenowi,3554,3462,92,24,62
Amphilophus_citrinellus,3613,3561,52,19,8
Archocentrus_centrarchus,3609,3534,75,18,13
Astatotilapia_calliptera,3569,3516,53,18,53
Maylandia_zebra,3606,3506,100,19,15
Haplochromis_chilotes,3589,3583,6,28,23
Haplochromis_sauvagei,3589,3584,5,27,24
Pundamilia_nyererei,3550,3539,11,44,46
Lithochromis_rufus,3585,3578,7,29,26
Haplochromis_burtoni,3585,3560,25,34,21
Petrochromis_trewavasae,3604,3528,76,28,8
Simochromis_diagramma,3597,3544,53,16,27
Tropheus_moorii,3595,3491,104,28,17
Neolamprologus_brichardi,3423,3393,30,121,96
Oreochromis_aureus,3613,3601,12,16,11
Oreochromis_niloticus,3620,3606,14,15,5
Oreochromis_grahami,3517,3503,14,83,40
Oreochromis_mossambicus,3506,3435,71,102,32
Pholidichthys_leucotaenia,3602,3546,56,28,10
Anableps_anableps,3613,3605,8,21,6
Gambusia_affinis,3599,3565,34,23,18
Xiphophorus_couchianus,3603,3592,11,24,13
Xiphophorus_maculatus,3614,3607,7,20,6
Xiphophorus_hellerii,3611,3544,67,21,8
Poeciliopsis_gracilis,3610,3598,12,20,10
Poeciliopsis_turneri,3596,3588,8,32,12
Poeciliopsis_turrubarensis,3563,3553,10,47,30
Poeciliopsis_infans,3348,3331,17,210,82
Poeciliopsis_occidentalis,3528,3355,173,72,40
Poeciliopsis_prolifica,3576,3370,206,19,45
Poeciliopsis_paucimaculata,3345,3332,13,206,89
Poeciliopsis_retropinna,3600,3588,12,24,16
Poecilia_formosa,3588,3417,171,31,21
Poecilia_latipinna,3540,3454,86,71,29
Poecilia_mexicana,3555,3455,100,60,25
Poecilia_picta,3589,3572,17,26,25
Poecilia_reticulata,3549,3537,12,53,38
Phalloptychus_januarius,3614,3606,8,21,5
Aphanius_iberus,3578,3557,21,34,28
Valencia_hispanica,3609,3600,9,21,10
Orestias_chungarensis,3584,3569,15,41,15
Orestias_laucaensis,3532,3520,12,40,68
Orestias_gloriae,3587,3577,10,36,17
Cyprinodon_diabolis,3582,3571,11,19,39
Cyprinodon_nevadensis_mionectes,3593,3550,43,33,14
Cyprinodon_tularosa,3582,3572,10,35,23
Cyprinodon_variegatus,3498,3462,36,73,69
Fundulus_heteroclitus,3587,3446,141,35,18
Girardinichthys_multiradiatus,3612,3482,130,20,8
Aphyosemion_australe,3582,3545,37,41,17
Nothobranchius_furzeri,3489,3471,18,40,111
Nothobranchius_kuhntae,3538,3501,37,62,40
Callopanchax_toddi,3571,3542,29,40,29
Pachypanchax_playfairii,3588,3569,19,33,19
Austrofundulus_limnaeus,3431,3420,11,126,83
Nematolebias_papilliferus,3369,3359,10,152,119
Nematolebias_whitei,3419,3399,20,120,101
Kryptolebias_brasiliensis,3558,3550,8,54,28
Kryptolebias_gracilis,3574,3568,6,42,24
Kryptolebias_hermaphroditus,3583,3574,9,37,20
Kryptolebias_marmoratus,3581,3569,12,35,24
Kryptolebias_ocellatus,3578,3571,7,39,23
Hirundichthys_speculiger,3599,3449,150,27,14
Xenentodon_cancila,3584,3580,4,28,28
Oryzias_celebensis,3604,3566,38,19,17
Oryzias_dopingdopingensis,3338,3324,14,200,102
Oryzias_woworae,3596,3549,47,27,17
Oryzias_javanicus,3608,3586,22,20,12
Oryzias_melastigma,3591,3577,14,34,15
Oryzias_curvinotus,3593,3448,145,24,23
Oryzias_latipes,3556,3547,9,27,57
Atherinomorus_stipes,3560,3488,72,55,25
Leptatherina_wallacei,3455,3447,8,109,76
Melanotaenia_boesemani,3614,3595,19,16,10
Melanotaenia_duboulayi,3604,3600,4,22,14
Telmatherina_bonti,3583,3572,11,33,24
Neostethus_bicornis,3558,3505,53,26,56
Odontesthes_bonariensis,3614,3607,7,21,5
Chelon_labrosus,3570,3543,27,43,27
Planiliza_haematocheilus,3575,3336,239,25,40
Mugil_cephalus,3578,3566,12,15,47
Parambassis_ranga,3612,3543,69,20,8
Anabas_testudineus,3610,3573,37,18,12
Ctenopoma_kingsleyae,3559,3552,7,56,25
Microctenopoma_lineatum,3557,3550,7,59,24
Microctenopoma_steveboyesi,3586,3581,5,38,16
Microctenopoma_stevenorrisi,3578,3574,4,42,20
Sandelia_bainsii,3593,3589,4,35,12
Helostoma_temminkii,3402,3391,11,175,63
Betta_splendens,3606,3585,21,24,10
Macropodus_opercularis,3613,3590,23,18,9
Channa_argus,3562,3551,11,21,57
Channa_maculata,3604,3590,14,14,22
Channa_striata,3616,3601,15,15,9
Mastacembelus_armatus,3595,3583,12,19,26
Monopterus_albus,3593,3586,7,31,16
Brachirus_orientalis,3590,3574,16,34,16
Microchirus_variegatus,3601,3577,24,24,15
Solea_senegalensis,3594,3503,91,24,22
Solea_solea,3607,3584,23,23,10
Cynoglossus_semilaevis,3564,3537,27,39,37
Paraplagusia_blochii,3483,3462,21,94,63
Colistium_nudipinnis,3593,3575,18,35,12
Trinectes_maculatus,3593,3573,20,32,15
Hippoglossus_hippoglossus,3612,3583,29,19,9
Hippoglossus_stenolepis,3611,3593,18,19,10
Reinhardtius_hippoglossoides,3617,3601,16,13,10
Verasper_variegatus,3614,3446,168,20,6
Platichthys_flesus,3613,3598,15,15,12
Platichthys_stellatus,3595,3577,18,30,15
Pleuronectes_platessa,3589,3562,27,26,25
Paralichthys_olivaceus,3443,3418,25,139,58
Pseudorhombus_dupliciocellatus,3607,3592,15,21,12
Scophthalmus_maximus,3604,3590,14,23,13
Psettodes_erumei,3582,3576,6,26,32
Caranx_ignobilis,3610,3575,35,21,9
Caranx_melampygus,3601,3319,282,22,17
Decapterus_maruadsi,3613,3602,11,20,7
Trachurus_trachurus,3603,3590,13,18,19
Seriola_aureovittata,3600,3594,6,20,20
Seriola_lalandi,3411,3389,22,157,72
Seriola_quinqueradiata,3582,3573,9,32,26
Seriola_dumerili,3615,3611,4,21,4
Seriola_rivoliana,3566,3557,9,22,52
Trachinotus_ovatus,3600,3575,25,24,16
Echeneis_naucrates,3611,3575,36,16,13
Istiophorus_platypterus,3529,3520,9,22,89
Xiphias_gladius,3603,3601,2,24,13
Toxotes_chatareus,3419,3404,15,20,201
Toxotes_jaculatrix,3609,3602,7,22,9
Lates_calcarifer,3616,3501,115,21,3
Lates_japonicus,3524,3372,152,82,34
Polydactylus_sextarius,3560,3552,8,16,64
Acanthopagrus_latus,3614,3604,10,22,4
Sparidentex_hasta,3426,3403,23,162,52
Diplodus_sargus,3553,3537,16,51,36
Sparus_aurata,3609,3572,37,20,11
Lutjanus_erythropterus,3606,3593,13,26,8
Acanthurus_leucopareius,3524,3513,11,84,32
Acanthurus_lineatus,3513,3505,8,101,26
Acanthurus_tennentii,3366,3349,17,171,103
Acanthurus_tractus,3452,3437,15,133,55
Ctenochaetus_hawaiiensis,3473,3462,11,123,44
Acanthurus_reversus,3364,3169,195,190,86
Naso_brevirostris,3325,3310,15,213,102
Naso_thynnoides,3348,3332,16,188,104
Chelmon_rostratus,3620,3606,14,18,2
Holacanthus_passer,3614,3608,6,17,9
Datnioides_undecimradiatus,3596,3511,85,30,14
Antennarius_maculatus,3593,3558,35,25,22
Lophius_piscatorius,3364,3341,23,201,75
Arothron_firmamentum,3491,3485,6,90,59
Pao_palembangensis,3577,3546,31,32,31
Tetraodon_nigroviridis,3346,3254,92,120,174
Takifugu_bimaculatus,3534,3322,212,29,77
Takifugu_flavidus,3568,3544,24,23,49
Takifugu_rubripes,3575,3437,138,21,44
Takifugu_ocellatus,3600,3577,23,16,24
Lagocephalus_sceleratus,3595,3584,11,17,28
Mola_mola,3582,3557,25,27,31
Thamnaconus_septentrionalis,3482,3466,16,17,141
Scatophagus_argus,3615,3611,4,20,5
Karalla_daura,3566,3549,17,36,38
Argyrosomus_japonicus,3621,3252,369,16,3
Argyrosomus_regius,3621,3603,18,16,3
Collichthys_lucidus,3569,3113,456,30,41
Larimichthys_crocea,3605,3594,11,30,5
Larimichthys_polyactis,3560,3238,322,21,59
Nibea_albiflora,3613,3504,109,22,5
Nibea_coibor,3619,3586,33,18,3
Protonibea_diacanthus,3609,3582,27,26,5
Sciaenops_ocellatus,3623,3584,39,15,2
Dicentrarchus_labrax,3618,3609,9,18,4
Morone_chrysops,3590,3585,5,42,8
Morone_saxatilis,3381,3366,15,127,132
Coreoperca_whiteheadi,3605,3598,7,25,10
Siniperca_chuatsi,3589,3586,3,17,34
Siniperca_knerii,3604,3598,6,29,7
Siniperca_obscura,3459,3435,24,122,59
Siniperca_undulata,3501,3480,21,93,46
Siniperca_scherzeri,3609,3601,8,21,10
Lepomis_macrochirus,3616,3595,21,20,4
Micropterus_dolomieu,3551,3539,12,69,20
Micropterus_salmoides,3588,3364,224,38,14
Maccullochella_peelii,3437,3424,13,167,36
Macquaria_ambigua,3534,3523,11,85,21
Macquaria_australasica,3579,3566,13,46,15
Oplegnathus_fasciatus,3573,3567,6,55,12
Scortum_barcoo,3612,3564,48,23,5
Terapon_puta,3547,3538,9,60,33
Lateolabrax_maculatus,3622,3616,6,16,2
Ammodytes_dubius,3524,3491,33,26,90
Ammodytes_marinus,3594,3575,19,21,25
Hyperoplus_immaculatus,3575,3561,14,33,32
Hyperoplus_lanceolatus,3561,3538,23,17,62
Cheilinus_undulatus,3592,3579,13,21,27
Labrus_bergylta,3582,3488,94,43,15
Symphodus_melops,3565,3554,11,36,39
Tautogolabrus_adspersus,3609,3599,10,25,6
Halichoeres_trimaculatus,3614,3602,12,18,8
Labroides_dimidiatus,3601,3587,14,22,17
Thalassoma_bifasciatum,3551,3064,487,70,19
Notolabrus_celidotus,3515,3501,14,38,87
Xyrichtys_novacula,3614,3600,14,16,10
Semicossyphus_pulcher,3622,3608,14,15,3
Anarrhichthys_ocellatus,3479,3435,44,103,58
Lycodopsis_pacificus,3605,3576,29,21,14
Melanostigma_gelatinosum,3600,3558,42,22,18
Ophthalmolycus_amberensis,3598,3501,97,28,14
Leptoclinus_maculatus,3595,3546,49,27,18
Pholis_gunnellus,3617,3608,9,17,6
Cebidichthys_violaceus,3430,3391,39,37,173
Apeltes_quadracus,3604,3589,15,23,13
Pungitius_pungitius,3608,3585,23,19,13
Gasterosteus_aculeatus_aculeatus,3583,3511,72,34,23
Gasterosteus_nipponicus,3579,3553,26,32,29
Clinocottus_analis,3595,3560,35,18,27
Taurulus_bubalis,3606,3588,18,25,9
Cottus_gobio,3602,3584,18,22,16
Cyclopterus_lumpus,3567,3548,19,26,47
Pseudoliparis_sp_Yap_Trench,3435,3001,434,56,149
Pseudoliparis_swirei,3533,3498,35,30,77
Ophiodon_elongatus,3575,3560,15,44,21
Anoplopoma_fimbria,3615,3591,24,20,5
Chelidonichthys_spinosus,3608,3594,14,20,12
Eutrigla_gurnardus,3613,3601,12,21,6
Pterois_miles,3613,3592,21,24,3
Sebastes_aleutianus,3602,3342,260,23,15
Sebastes_variabilis,3352,3315,37,218,70
Sebastes_crameri,3364,3342,22,216,60
Sebastes_reedi,3440,3412,28,160,40
Sebastes_wilsoni,3329,3294,35,244,67
Sebastes_diaconus,3469,3450,19,128,43
Sebastes_mystinus,3383,3365,18,206,51
Sebastes_entomelas,3612,3597,15,21,7
Sebastes_flavidus,3355,3328,27,221,64
Sebastes_atrovirens,3348,3326,22,222,70
Sebastes_dallii,3423,3400,23,155,62
Sebastes_rastrelliger,3404,3377,27,176,60
Sebastes_semicinctus,3385,3365,20,189,66
Sebastes_melanostomus,3314,3289,25,242,84
Sebastes_chlorostictus,3419,3397,22,167,54
Sebastes_rosaceus,3594,2951,643,22,24
Sebastes_umbrosus,3600,3582,18,17,23
Sebastes_constellatus,3437,3413,24,159,44
Sebastes_oculatus,3376,3352,24,205,59
Sebastes_exsul,3309,3285,24,245,86
Sebastes_hopkinsi,3399,3371,28,186,55
Sebastes_moseri,3402,3386,16,185,53
Sebastes_rubrivinctus,3390,3367,23,179,71
Sebastes_miniatus,3607,3408,199,23,10
Sebastes_pinniger,3598,3466,132,22,20
Sebastes_cheni,3375,3354,21,200,65
Sebastes_inermis,3394,3371,23,189,57
Sebastes_joyneri,3353,3329,24,214,73
Sebastes_thompsoni,3317,3295,22,251,72
Sebastes_nivosus,3369,3350,19,195,76
Sebastes_pachycephalus,3359,3340,19,216,65
Sebastes_schlegelii,3596,3532,64,24,20
Sebastes_scythropus,3369,3342,27,203,68
Sebastolobus_alascanus,3599,3586,13,24,17
Synanceia_verrucosa,3578,3562,16,24,38
Bovichtus_diacanthus,3390,3374,16,153,97
Bovichtus_variegatus,3398,3385,13,147,95
Cottoperca_gobio,3458,3409,49,42,140
Chaenocephalus_aceratus,3435,3318,117,63,142
Pseudochaenichthys_georgianus,3468,3428,40,65,107
Gymnodraco_acuticeps,3441,3408,33,74,125
Harpagifer_antarcticus,3473,3343,130,49,118
Pogonophryne_albipinna,3555,3427,128,42,43
Notothenia_rossii,3500,3489,11,71,69
Trematomus_bernacchii,3576,3540,36,36,28
Trematomus_loennbergii,3581,3160,421,32,27
Dissostichus_eleginoides,3610,3465,145,20,10
Dissostichus_mawsoni,3597,3432,165,25,18
Etheostoma_cragini,3495,3489,6,71,74
Etheostoma_nigrum,3560,3540,20,56,24
Etheostoma_perlongum,3576,3533,43,31,33
Etheostoma_spectabile,3488,3360,128,32,120
Percina_caprodes,3589,3129,460,19,32
Gymnocephalus_cernua,3604,3588,16,16,20
Perca_flavescens,3604,3589,15,26,10
Perca_schrenkii,3600,3594,6,29,11
Perca_fluviatilis,3583,3572,11,40,17
Sander_lucioperca,3614,3594,20,22,4
Sander_vitreus,3606,3598,8,25,9
Zingel_zingel,3609,3596,13,22,9
Centropristis_striata,3614,3604,10,16,10
Hypoplectrus_aberrans,3412,3395,17,146,82
Hypoplectrus_chlorurus,3373,3360,13,180,87
Hypoplectrus_indigo,3401,3381,20,162,77
Hypoplectrus_randallorum,3475,3465,10,108,57
Hypoplectrus_puella,3585,3577,8,34,21
Hypoplectrus_providencianus,3393,3379,14,154,93
Hypoplectrus_guttavarius,3391,3378,13,155,94
Hypoplectrus_nigricans,3381,3367,14,162,97
Serranus_cabrilla,3505,3482,23,84,51
Cephalopholis_sonnerati,3599,3520,79,22,19
Cromileptes_altivelis,3544,3533,11,24,72
Epinephelus_fuscoguttatus,3611,3591,20,23,6
Epinephelus_coioides,3606,3587,19,26,8
Epinephelus_lanceolatus,3591,3558,33,41,8
Epinephelus_moara,3598,3585,13,30,12
Epinephelus_cyanopodus,3605,3569,36,26,9
Plectropomus_leopardus,3479,3427,52,97,64
Aeoliscus_strigatus,3426,3409,17,135,79
Fistularia_tabacaria,3336,3320,16,186,118
Corythoichthys_intestinalis,3551,3461,90,39,50
Hippocampus_abdominalis,3583,3568,15,25,32
Hippocampus_barbouri,3558,3547,11,38,44
Hippocampus_comes,3556,3539,17,46,38
Hippocampus_mohnikei,3546,3383,163,26,68
Hippocampus_guttulatus,3552,3544,8,42,46
Hippocampus_zosterae,3576,3507,69,23,41
Syngnathus_acus,3545,3514,31,35,60
Syngnathus_rostellatus,3340,3325,15,134,166
Syngnathus_typhle,3527,3504,23,46,67
Syngnathus_scovelli,3551,3533,18,30,59
Phycodurus_eques,3559,3544,15,34,47
Phyllopteryx_taeniolatus,3555,3542,13,38,47
Syngnathoides_biaculeatus,3544,3526,18,36,60
Doryrhamphus_excisus,3587,3496,91,27,26
Dunckerocampus_dactyliophorus,3599,3583,16,23,18
Oostethus_manadensis,3562,3511,51,38,40
Callionymus_lyra,3526,3504,22,40,74
Synchiropus_splendidus,3564,3489,75,19,57
Mullus_surmuletus,3228,3191,37,206,206
Euthynnus_affinis,3617,3558,59,17,6
Thunnus_albacares,3615,3609,6,19,6
Thunnus_maccoyii,3617,3612,5,19,4
Thunnus_orientalis,3610,3528,82,19,11
Scomber_colias,3561,3540,21,34,45
Scomber_japonicus,3590,3572,18,27,23
Lepturacanthus_savala,3549,3541,8,19,72
Boleophthalmus_pectinirostris,3535,3505,30,53,52
Odontamblyopus_lacepedii,3591,3555,36,24,25
Odontamblyopus_rebecca,3596,3562,34,21,23
Taenioides_sp_WSHXM2023,3595,3583,12,22,23
Periophthalmus_magnuspinnatus,3569,3534,35,24,47
Periophthalmus_modestus,3539,3409,130,29,72
Chaenogobius_annularis,3494,3440,54,42,104
Eucyclogobius_newberryi,3518,3482,36,33,89
Rhinogobius_similis,3542,3525,17,23,75
Mugilogobius_chulae,3543,3498,45,44,53
Gobius_niger,3580,3564,16,24,36
Neogobius_melanostomus,3566,3513,53,35,39
Proterorhinus_semilunaris,3561,3544,17,28,51
Bostrychus_sinensis,3582,3553,29,22,36
Neodontobutis_hainanensis,3507,3391,116,25,108
Perccottus_glenii,3596,3527,69,22,22
Ostorhinchus_cyanosoma,3332,3308,24,178,130
Siphamia_tubifer,3595,3291,304,27,18
Sphaeramia_orbicularis,3597,3484,113,24,19
Thalassophryne_amazonica,3541,3473,68,40,59
Brotula_barbata,3310,3291,19,191,139
Lucifuga_dentata,3403,3392,11,166,71
Centroberyx_gerrardi,3572,3552,20,54,14
Myripristis_murdjan,3610,3583,27,21,9
Lampris_incognitus,3543,3507,36,36,61
Lampris_megalopsis,3579,3516,63,27,34
Coryphaenoides_rupestris,3353,3153,200,116,171
Muraenolepis_orangiensis,3532,3454,78,28,80
Gadus_chalcogrammus,3418,3256,162,53,169
Gadus_morhua,3495,3461,34,38,107
Gadus_macrocephalus,3385,3357,28,71,184
Melanogrammus_aeglefinus,3465,3410,55,69,106
Pollachius_pollachius,3554,3531,23,31,55
Lota_lota,3560,3523,37,29,51
Molva_macrophthalma,3327,3302,25,154,159
Zeus_faber,3577,3540,37,29,34
Electrona_antarctica,3563,3252,311,26,51
Gymnoscopelus_braueri,3588,3219,369,23,29
Gymnoscopelus_microlampas,3601,3274,327,22,17
Galaxias_olidus,3425,3395,30,110,105
Borostomias_antarcticus,3506,3436,70,58,76
Hypomesus_transpacificus,3338,3301,37,35,267
Thaleichthys_pacificus,3536,3494,42,35,69
Mallotus_villosus,3454,3321,133,64,122
Neosalanx_taihuensis,3438,3389,49,45,157
Protosalanx_chinensis,3301,3227,74,54,285
Plecoglossus_altivelis,3528,3498,30,33,79
Argentina_silus,3572,3502,70,39,29
Brachymystax_lenok_tsinlingensis,3611,2235,1376,18,11
Hucho_hucho,3354,2029,1325,147,139
Oncorhynchus_gorbuscha,3602,2155,1447,28,10
Oncorhynchus_keta,3596,2179,1417,26,18
Oncorhynchus_kisutch,3601,2053,1548,28,11
Oncorhynchus_tshawytscha,3603,2175,1428,25,12
Oncorhynchus_mykiss,3616,2007,1609,18,6
Salvelinus_fontinalis,3586,2069,1517,40,14
Salvelinus_namaycush,3487,1970,1517,65,88
Salvelinus_sp_IW2-2015,3369,2175,1194,82,189
Salmo_salar,3605,1932,1673,27,8
Salmo_trutta,3586,1970,1616,31,23
Coregonus_clupeaformis,3593,1862,1731,32,15
Coregonus_sp_balchen,3483,2220,1263,58,99
Coregonus_ussuriensis,3520,1654,1866,33,87
Thymallus_thymallus,3589,2100,1489,20,31
Dallia_pectoralis,3436,3403,33,34,170
Esox_lucius,3604,3582,22,18,18
Albula_glossodonta,3581,3222,359,25,34
Albula_goreensis,3547,3304,243,18,75
Aldrovandia_affinis,3471,3212,259,31,138
Anguilla_anguilla,3565,3329,236,26,49
Anguilla_rostrata,3568,3332,236,27,45
Anguilla_japonica,3556,3314,242,21,63
Conger_conger,3415,3227,188,36,189
Gymnothorax_javanicus,3522,3375,147,40,78
Gymnothorax_reevesii,3537,3383,154,42,61
Ilyophis_sp_1_JC-2022,3564,3235,329,28,48
Ilyophis_sp_2_JC-2022,3570,3280,290,25,45
Synaphobranchus_kaupii,3493,3261,232,58,89
Megalops_atlanticus,3579,3251,328,21,40
Megalops_cyprinoides,3597,3272,325,20,23
Arapaima_gigas,3560,3497,63,40,40
Heterotis_niloticus,3578,3497,81,33,29
Scleropages_formosus,3599,3505,94,23,18
Boulengeromyrus_knoepffleri,3530,3471,59,61,49
Ivindomyrus_marchei,3544,3486,58,49,47
Ivindomyrus_opdenboschi,3526,3465,61,64,50
Cryptomyrus_ogoouensis,3549,3495,54,51,40
Paramormyrops_hopkinsi,3529,3475,54,65,46
Paramormyrops_sp_MAG,3558,3500,58,51,31
Paramormyrops_kingsleyae,3587,3533,54,35,18
Brevimyrus_niger,3548,3501,47,46,46
Pollimyrus_isidori,3546,3496,50,54,40
Pollimyrus_plagiostoma,3562,3516,46,36,42
Stomatorhinus_ivindoensis,3563,3508,55,39,38
Stomatorhinus_walkeri,3543,3490,53,48,49
Campylomormyrus_compressirostris,3559,3479,80,44,37
Campylomormyrus_numenius,3525,3467,58,69,46
Campylomormyrus_tamandua,3541,3486,55,56,43
Gnathonemus_longibarbis,3554,3496,58,43,43
Genyomyrus_donnyi,3544,3484,60,53,43
Marcusenius_schilthuisiae,3525,3466,59,52,63
Gnathonemus_echidnorhynchus,3536,3482,54,60,44
Cyphomyrus_discorhynchus,3534,3472,62,66,40
Cyphomyrus_wilverthi,3529,3467,62,52,59
Heteromormyrus_longilateralis,3542,3488,54,48,50
Heteromormyrus_szaboi,3543,3487,56,47,50
Heteromormyrus_pauciradiatus,3540,3481,59,55,45
Marcusenius_ussheri,3542,3483,59,49,49
Hippopotamyrus_pictus,3545,3488,57,53,42
Hyperopisus_bebe,3554,3498,56,46,40
Mormyrus_hasselquistii,3540,3489,51,55,45
Mormyrus_lacerda,3562,3505,57,41,37
Mormyrus_proboscirostris,3558,3509,49,41,41
Brienomyrus_brachyistius,3597,3485,112,23,20
Brienomyrus_longianalis,3543,3488,55,49,48
Isichthys_henryi,3543,3494,49,54,43
Mormyrops_attenuatus,3551,3498,53,48,41
Mormyrops_boulengeri,3559,3508,51,43,38
Mormyrops_zanclirostris,3526,3480,46,64,50
Mormyrus_iriodes,3553,3493,60,48,39
Myomyrus_macrops,3557,3496,61,45,38
Myomyrus_pharao,3571,3524,47,35,34
Petrocephalus_microphthalmus,3309,3248,61,193,138
Petrocephalus_schoutedeni,3500,3434,66,76,64
Petrocephalus_sullivani,3486,3432,54,96,58
Petrocephalus_zakoni,3477,3422,55,85,78
Gymnarchus_niloticus,3354,3297,57,176,110
Amia_calva,3497,3482,15,71,72
Atractosteus_spatula,3513,3496,17,75,52
Lepisosteus_oculatus,3461,3447,14,111,68
Acipenser_oxyrinchus_oxyrinchus,3510,1066,2444,35,95
Acipenser_ruthenus,3526,947,2579,33,81
Polyodon_spathula,3477,1899,1578,55,108
Erpetoichthys_calabaricus,3423,3378,45,58,159
Polypterus_bichir_lapradei,3161,3114,47,134,345
Polypterus_senegalus,3318,3285,33,83,239
Amblyraja_radiata,3165,3093,72,47,142
Leucoraja_erinacea,3185,3098,87,51,118
Raja_brachyura,3160,3099,61,64,130
Hypanus_sabinus,3235,3153,82,50,69
Mobula_birostris,3178,3104,74,54,122
Pristis_pectinata,3217,3150,67,44,93
Carcharodon_carcharias,3261,3189,72,46,47
Isurus_oxyrinchus,3243,3138,105,49,62
Scyliorhinus_canicula,3180,3073,107,56,118
Sphyrna_mokarran,3238,3167,71,38,78
Chiloscyllium_punctatum,2874,2824,50,270,210
Hemiscyllium_ocellatum,3261,3194,67,40,53
Ginglymostoma_cirratum,3027,2956,71,120,207
Stegostoma_tigrinum,3203,3141,62,39,112
Squalus_acanthias,3157,3078,79,89,108
Squalus_suckleyi,3053,2970,83,166,135
Callorhinchus_milii,3043,2959,84,110,201
Entosphenus_tridentatus,1678,1631,47,490,1186
Lethenteron_camtschaticum,1713,1571,142,454,1187
Lethenteron_reissneri,2366,2085,281,102,886
Petromyzon_marinus,2540,2426,114,120,694
Eptatretus_burgeri,1677,1638,39,512,1165
